id,user_id,user_name,sentence_index,char_index,char_1,char_2,DD,DU,UD,UU,H1,H2
1,1,Neha,0,0,97,110,258,385,75,202,183,127
2,1,Neha,0,1,110,114,511,624,384,497,127,113
3,1,Neha,0,2,114,8,747,841,634,728,113,94
4,1,Neha,0,3,8,121,345,455,251,361,94,110
5,1,Neha,0,4,121,32,253,366,143,256,110,113
6,1,Neha,0,5,32,116,357,522,244,409,113,165
7,1,Neha,0,6,116,114,216,309,51,144,165,93
8,1,Neha,0,7,114,97,192,358,99,265,93,166
9,1,Neha,0,8,97,110,495,606,329,440,166,111
10,1,Neha,0,9,110,115,324,494,213,383,111,170
11,1,Neha,0,10,115,105,227,313,57,143,170,86
12,1,Neha,0,11,105,116,457,606,371,520,86,149
13,1,Neha,0,12,116,105,207,366,58,217,149,159
14,1,Neha,0,13,105,111,86,236,-73,77,159,150
15,1,Neha,0,14,111,110,247,348,97,198,150,101
16,1,Neha,0,15,110,32,180,275,79,174,101,95
17,1,Neha,0,16,32,105,1250,1349,1155,1254,95,99
18,1,Neha,0,17,105,115,289,444,190,345,99,155
19,1,Neha,0,18,115,32,339,455,184,300,155,116
20,1,Neha,0,19,32,101,323,418,207,302,116,95
21,1,Neha,0,20,101,97,423,566,328,471,95,143
22,1,Neha,0,21,97,115,281,404,138,261,143,123
23,1,Neha,0,22,115,105,366,475,243,352,123,109
24,1,Neha,0,23,105,101,448,634,339,525,109,186
25,1,Neha,0,24,101,114,113,255,-73,69,186,142
26,1,Neha,0,25,114,32,391,500,249,358,142,109
27,1,Neha,0,26,32,105,779,869,670,760,109,90
28,1,Neha,0,27,105,102,293,441,203,351,90,148
29,1,Neha,0,28,102,32,132,202,-16,54,148,70
30,1,Neha,0,29,32,121,430,530,360,460,70,100
31,1,Neha,0,30,121,111,215,310,115,210,100,95
32,1,Neha,0,31,111,117,210,298,115,203,95,88
33,1,Neha,0,32,117,32,196,294,108,206,88,98
34,1,Neha,0,33,32,98,280,368,182,270,98,88
35,1,Neha,0,34,98,101,271,418,183,330,88,147
36,1,Neha,0,35,101,108,269,367,122,220,147,98
37,1,Neha,0,36,108,105,196,275,98,177,98,79
38,1,Neha,0,37,105,101,448,591,369,512,79,143
39,1,Neha,0,38,101,118,306,415,163,272,143,109
40,1,Neha,0,39,118,101,77,213,-32,104,109,136
41,1,Neha,0,40,101,32,153,249,17,113,136,96
42,1,Neha,0,41,32,105,429,550,333,454,96,121
43,1,Neha,0,42,105,110,179,288,58,167,121,109
44,1,Neha,0,43,110,32,188,300,79,191,109,112
45,1,Neha,0,44,32,121,1309,1456,1197,1344,112,147
46,1,Neha,0,45,121,111,195,305,48,158,147,110
47,1,Neha,0,46,111,117,288,376,178,266,110,88
48,1,Neha,0,47,117,114,412,522,324,434,88,110
49,1,Neha,0,48,114,115,340,474,230,364,110,134
50,1,Neha,0,49,115,101,225,369,91,235,134,144
51,1,Neha,0,50,101,108,531,643,387,499,144,112
52,1,Neha,0,51,108,102,144,291,32,179,112,147
53,1,Neha,0,52,102,32,180,249,33,102,147,69
54,1,Neha,0,53,32,110,1325,1401,1256,1332,69,76
55,1,Neha,0,54,110,8,695,826,619,750,76,131
56,1,Neha,0,55,8,97,872,1047,741,916,131,175
57,1,Neha,0,56,97,110,229,312,54,137,175,83
58,1,Neha,0,57,110,100,233,385,150,302,83,152
59,1,Neha,0,58,100,32,60,183,-92,31,152,123
60,1,Neha,0,59,32,121,427,555,304,432,123,128
61,1,Neha,0,60,121,111,328,430,200,302,128,102
62,1,Neha,0,61,111,117,229,313,127,211,102,84
63,1,Neha,0,62,117,114,254,414,170,330,84,160
64,1,Neha,0,63,114,32,145,248,-15,88,160,103
65,1,Neha,0,64,32,116,322,414,219,311,103,92
66,1,Neha,0,65,116,97,128,289,36,197,92,161
67,1,Neha,0,66,97,108,464,588,303,427,161,124
68,1,Neha,0,67,108,101,242,375,118,251,124,133
69,1,Neha,0,68,101,110,180,286,47,153,133,106
70,1,Neha,0,69,110,116,245,341,139,235,106,96
71,1,Neha,1,0,13,105,1024,1125,933,1034,91,101
72,1,Neha,1,1,105,116,244,349,143,248,101,105
73,1,Neha,1,2,116,32,272,384,167,279,105,112
74,1,Neha,1,3,32,100,326,444,214,332,112,118
75,1,Neha,1,4,100,111,190,281,72,163,118,91
76,1,Neha,1,5,111,101,309,427,218,336,91,118
77,1,Neha,1,6,101,115,219,364,101,246,118,145
78,1,Neha,1,7,115,32,219,294,74,149,145,75
79,1,Neha,1,8,32,110,330,422,255,347,75,92
80,1,Neha,1,9,110,111,236,335,144,243,92,99
81,1,Neha,1,10,111,116,348,443,249,344,99,95
82,1,Neha,1,11,116,32,231,358,136,263,95,127
83,1,Neha,1,12,32,109,368,475,241,348,127,107
84,1,Neha,1,13,109,97,195,353,88,246,107,158
85,1,Neha,1,14,97,116,211,301,53,143,158,90
86,1,Neha,1,15,116,116,124,239,34,149,90,115
87,1,Neha,1,16,116,101,194,330,79,215,115,136
88,1,Neha,1,17,101,114,156,258,20,122,136,102
89,1,Neha,1,18,114,32,344,475,242,373,102,131
90,1,Neha,1,19,32,104,300,391,169,260,131,91
91,1,Neha,1,20,104,111,591,686,500,595,91,95
92,1,Neha,1,21,111,119,394,570,299,475,95,176
93,1,Neha,1,22,119,32,196,247,20,71,176,51
94,1,Neha,1,23,32,115,302,426,251,375,51,124
95,1,Neha,1,24,115,108,218,308,94,184,124,90
96,1,Neha,1,25,108,111,142,229,52,139,90,87
97,1,Neha,1,26,111,119,571,722,484,635,87,151
98,1,Neha,1,27,119,108,221,313,70,162,151,92
99,1,Neha,1,28,108,121,584,692,492,600,92,108
100,1,Neha,1,29,121,32,307,422,199,314,108,115
101,1,Neha,1,30,32,121,938,1027,823,912,115,89
102,1,Neha,1,31,121,111,540,650,451,561,89,110
103,1,Neha,1,32,111,117,230,332,120,222,110,102
104,1,Neha,1,33,117,32,261,353,159,251,102,92
105,1,Neha,1,34,32,103,632,788,540,696,92,156
106,1,Neha,1,35,103,111,203,319,47,163,156,116
107,1,Neha,1,36,111,32,264,370,148,254,116,106
108,1,Neha,1,37,32,97,241,411,135,305,106,170
109,1,Neha,1,38,97,32,348,457,178,287,170,109
110,1,Neha,1,39,32,115,1249,1439,1140,1330,109,190
111,1,Neha,1,40,115,8,372,473,182,283,190,101
112,1,Neha,1,41,8,8,281,427,180,326,101,146
113,1,Neha,1,42,8,115,370,523,224,377,146,153
114,1,Neha,1,43,115,32,403,513,250,360,153,110
115,1,Neha,1,44,32,108,210,317,100,207,110,107
116,1,Neha,1,45,108,111,182,288,75,181,107,106
117,1,Neha,1,46,111,110,267,379,161,273,106,112
118,1,Neha,1,47,110,103,394,498,282,386,112,104
119,1,Neha,1,48,103,32,147,249,43,145,104,102
120,1,Neha,1,49,32,97,318,528,216,426,102,210
121,1,Neha,1,50,97,115,193,363,-17,153,210,170
122,1,Neha,1,51,115,32,208,309,38,139,170,101
123,1,Neha,1,52,32,121,1740,1821,1639,1720,101,81
124,1,Neha,1,53,121,111,453,546,372,465,81,93
125,1,Neha,1,54,111,117,228,315,135,222,93,87
126,1,Neha,1,55,117,32,227,320,140,233,87,93
127,1,Neha,1,56,32,100,368,501,275,408,93,133
128,1,Neha,1,57,100,111,238,316,105,183,133,78
129,1,Neha,1,58,111,32,233,317,155,239,78,84
130,1,Neha,1,59,32,110,1002,1089,918,1005,84,87
131,1,Neha,1,60,110,111,362,474,275,387,87,112
132,1,Neha,1,61,111,116,594,695,482,583,112,101
133,1,Neha,1,62,116,32,262,361,161,260,101,99
134,1,Neha,1,63,32,115,230,395,131,296,99,165
135,1,Neha,1,64,115,116,198,280,33,115,165,82
136,1,Neha,1,65,116,111,680,772,598,690,82,92
137,1,Neha,1,66,111,112,176,267,84,175,92,91
138,1,Neha,2,0,13,119,1373,1545,1248,1420,125,172
139,1,Neha,2,1,119,101,152,336,-20,164,172,184
140,1,Neha,2,2,101,32,164,289,-20,105,184,125
141,1,Neha,2,3,32,107,819,968,694,843,125,149
142,1,Neha,2,4,107,110,181,252,32,103,149,71
143,1,Neha,2,5,110,111,340,417,269,346,71,77
144,1,Neha,2,6,111,119,491,647,414,570,77,156
145,1,Neha,2,7,119,32,189,296,33,140,156,107
146,1,Neha,2,8,32,119,1004,1150,897,1043,107,146
147,1,Neha,2,9,119,104,335,429,189,283,146,94
148,1,Neha,2,10,104,97,125,279,31,185,94,154
149,1,Neha,2,11,97,116,174,261,20,107,154,87
150,1,Neha,2,12,116,32,297,406,210,319,87,109
151,1,Neha,2,13,32,119,1033,1229,924,1120,109,196
152,1,Neha,2,14,119,101,234,392,38,196,196,158
153,1,Neha,2,15,101,32,176,275,18,117,158,99
154,1,Neha,2,16,32,97,236,388,137,289,99,152
155,1,Neha,2,17,97,114,254,366,102,214,152,112
156,1,Neha,2,18,114,101,80,190,-32,78,112,110
157,1,Neha,2,19,101,32,359,466,249,356,110,107
158,1,Neha,2,20,32,98,308,402,201,295,107,94
159,1,Neha,2,21,98,117,202,295,108,201,94,93
160,1,Neha,2,22,117,116,272,364,179,271,93,92
161,1,Neha,2,23,116,32,234,340,142,248,92,106
162,1,Neha,2,24,32,107,424,556,318,450,106,132
163,1,Neha,2,25,107,110,171,271,39,139,132,100
164,1,Neha,2,26,110,111,243,331,143,231,100,88
165,1,Neha,2,27,111,119,409,575,321,487,88,166
166,1,Neha,2,28,119,32,183,259,17,93,166,76
167,1,Neha,2,29,32,110,578,679,502,603,76,101
168,1,Neha,2,30,110,111,278,392,177,291,101,114
169,1,Neha,2,31,111,116,354,455,240,341,114,101
170,1,Neha,2,32,116,32,259,357,158,256,101,98
171,1,Neha,2,33,32,119,1720,1886,1622,1788,98,166
172,1,Neha,2,34,119,104,1463,1571,1297,1405,166,108
173,1,Neha,2,35,104,97,126,271,18,163,108,145
174,1,Neha,2,36,97,116,694,789,549,644,145,95
175,1,Neha,2,37,116,32,273,370,178,275,95,97
176,1,Neha,2,38,32,119,717,900,620,803,97,183
177,1,Neha,2,39,119,101,166,339,-17,156,183,173
178,1,Neha,2,40,101,32,135,263,-38,90,173,128
179,1,Neha,2,41,32,109,347,444,219,316,128,97
180,1,Neha,2,42,109,97,155,311,58,214,97,156
181,1,Neha,2,43,97,121,193,285,37,129,156,92
182,1,Neha,2,44,121,32,635,745,543,653,92,110
183,1,Neha,2,45,32,98,224,329,114,219,110,105
184,1,Neha,2,46,98,101,146,266,41,161,105,120
185,1,Neha,3,0,13,121,1072,1168,961,1057,111,96
186,1,Neha,3,1,121,111,457,552,361,456,96,95
187,1,Neha,3,2,111,117,234,315,139,220,95,81
188,1,Neha,3,3,117,32,267,349,186,268,81,82
189,1,Neha,3,4,32,99,663,739,581,657,82,76
190,1,Neha,3,5,99,97,95,269,19,193,76,174
191,1,Neha,3,6,97,110,404,480,230,306,174,76
192,1,Neha,3,7,110,116,255,349,179,273,76,94
193,1,Neha,3,8,116,32,282,378,188,284,94,96
194,1,Neha,3,9,32,97,698,864,602,768,96,166
195,1,Neha,3,10,97,108,226,315,60,149,166,89
196,1,Neha,3,11,108,119,392,531,303,442,89,139
197,1,Neha,3,12,119,97,242,396,103,257,139,154
198,1,Neha,3,13,97,121,186,286,32,132,154,100
199,1,Neha,3,14,121,115,85,234,-15,134,100,149
200,1,Neha,3,15,115,32,181,260,32,111,149,79
201,1,Neha,3,16,32,104,950,1056,871,977,79,106
202,1,Neha,3,17,104,97,85,256,-21,150,106,171
203,1,Neha,3,18,97,118,265,360,94,189,171,95
204,1,Neha,3,19,118,101,129,308,34,213,95,179
205,1,Neha,3,20,101,32,160,261,-19,82,179,101
206,1,Neha,3,21,32,97,181,354,80,253,101,173
207,1,Neha,3,22,97,32,155,242,-18,69,173,87
208,1,Neha,3,23,32,103,855,941,768,854,87,86
209,1,Neha,3,24,103,111,460,539,374,453,86,79
210,1,Neha,3,25,111,111,117,246,38,167,79,129
211,1,Neha,3,26,111,100,272,433,143,304,129,161
212,1,Neha,3,27,100,32,952,1079,791,918,161,127
213,1,Neha,3,28,32,100,836,920,709,793,127,84
214,1,Neha,3,29,100,97,335,455,251,371,84,120
215,1,Neha,3,30,97,121,163,252,43,132,120,89
216,1,Neha,3,31,121,32,235,335,146,246,89,100
217,1,Neha,3,32,32,98,308,413,208,313,100,105
218,1,Neha,3,33,98,117,363,463,258,358,105,100
219,1,Neha,3,34,117,116,279,374,179,274,100,95
220,1,Neha,3,35,116,32,302,425,207,330,95,123
221,1,Neha,3,36,32,121,745,847,622,724,123,102
222,1,Neha,3,37,121,111,478,569,376,467,102,91
223,1,Neha,3,38,111,117,197,298,106,207,91,101
224,1,Neha,3,39,117,32,247,357,146,256,101,110
225,1,Neha,3,40,32,99,266,356,156,246,110,90
226,1,Neha,3,41,99,97,140,316,50,226,90,176
227,1,Neha,3,42,97,110,304,400,128,224,176,96
228,1,Neha,3,43,110,32,153,234,57,138,96,81
229,1,Neha,3,44,32,97,874,1050,793,969,81,176
230,1,Neha,3,45,97,108,367,466,191,290,176,99
231,1,Neha,3,46,108,119,306,447,207,348,99,141
232,1,Neha,3,47,119,97,221,369,80,228,141,148
233,1,Neha,3,48,97,121,202,296,54,148,148,94
234,1,Neha,3,49,121,115,60,207,-34,113,94,147
235,1,Neha,3,50,115,32,198,293,51,146,147,95
236,1,Neha,3,51,32,103,1092,1204,997,1109,95,112
237,1,Neha,3,52,103,97,62,248,-50,136,112,186
238,1,Neha,3,53,97,8,4776,4846,4590,4660,186,70
239,1,Neha,3,54,8,8,123,206,53,136,70,83
240,1,Neha,3,55,8,8,323,405,240,322,83,82
241,1,Neha,3,56,8,102,673,797,591,715,82,124
242,1,Neha,3,57,102,97,101,276,-23,152,124,175
243,1,Neha,3,58,97,99,193,279,18,104,175,86
244,1,Neha,3,59,99,101,141,277,55,191,86,136
245,1,Neha,3,60,101,32,157,255,21,119,136,98
246,1,Neha,3,61,32,97,202,342,104,244,98,140
247,1,Neha,3,62,97,32,159,211,19,71,140,52
248,1,Neha,3,63,32,98,1379,1475,1327,1423,52,96
249,1,Neha,3,64,98,97,150,328,54,232,96,178
250,1,Neha,3,65,97,100,289,444,111,266,178,155
251,1,Neha,3,66,100,32,187,280,32,125,155,93
252,1,Neha,3,67,32,100,317,466,224,373,93,149
253,1,Neha,3,68,100,97,231,407,82,258,149,176
254,1,Neha,3,69,97,121,206,296,30,120,176,90
255,1,Neha,3,70,121,32,190,336,100,246,90,146
256,1,Neha,3,71,32,119,1136,1285,990,1139,146,149
257,1,Neha,3,72,119,105,190,292,41,143,149,102
258,1,Neha,3,73,105,116,382,488,280,386,102,106
259,1,Neha,3,74,116,104,186,300,80,194,106,114
260,1,Neha,3,75,104,32,254,358,140,244,114,104
261,1,Neha,3,76,32,97,221,373,117,269,104,152
262,1,Neha,3,77,97,32,184,250,32,98,152,66
263,1,Neha,3,78,32,103,578,725,512,659,66,147
264,1,Neha,3,79,103,111,238,318,91,171,147,80
265,1,Neha,3,80,111,111,114,194,34,114,80,80
266,1,Neha,3,81,111,100,501,634,421,554,80,133
267,1,Neha,3,82,100,32,165,247,32,114,133,82
268,1,Neha,3,83,32,97,232,389,150,307,82,157
269,1,Neha,3,84,97,116,274,361,117,204,157,87
270,1,Neha,3,85,116,116,118,208,31,121,87,90
271,1,Neha,3,86,116,105,502,589,412,499,90,87
272,1,Neha,3,87,105,116,310,404,223,317,87,94
273,1,Neha,3,88,116,117,1062,1143,968,1049,94,81
274,1,Neha,3,89,117,100,316,452,235,371,81,136
275,1,Neha,3,90,100,101,180,332,44,196,136,152
276,1,Neha,4,0,13,116,1397,1477,1282,1362,115,80
277,1,Neha,4,1,116,104,154,269,74,189,80,115
278,1,Neha,4,2,104,101,179,368,64,253,115,189
279,1,Neha,4,3,101,32,158,259,-31,70,189,101
280,1,Neha,4,4,32,98,289,386,188,285,101,97
281,1,Neha,4,5,98,101,299,380,202,283,97,81
282,1,Neha,4,6,101,115,182,343,101,262,81,161
283,1,Neha,4,7,115,116,137,230,-24,69,161,93
284,1,Neha,4,8,116,32,236,337,143,244,93,101
285,1,Neha,4,9,32,112,474,559,373,458,101,85
286,1,Neha,4,10,112,114,411,532,326,447,85,121
287,1,Neha,4,11,114,101,106,202,-15,81,121,96
288,1,Neha,4,12,101,112,404,495,308,399,96,91
289,1,Neha,4,13,112,97,126,319,35,228,91,193
290,1,Neha,4,14,97,114,277,359,84,166,193,82
291,1,Neha,4,15,114,97,65,199,-17,117,82,134
292,1,Neha,4,16,97,116,153,254,19,120,134,101
293,1,Neha,4,17,116,105,525,670,424,569,101,145
294,1,Neha,4,18,105,111,87,224,-58,79,145,137
295,1,Neha,4,19,111,110,236,314,99,177,137,78
296,1,Neha,4,20,110,32,158,259,80,181,78,101
297,1,Neha,4,21,32,102,302,446,201,345,101,144
298,1,Neha,4,22,102,111,236,323,92,179,144,87
299,1,Neha,4,23,111,114,259,389,172,302,87,130
300,1,Neha,4,24,114,32,162,240,32,110,130,78
301,1,Neha,4,25,32,116,1391,1488,1313,1410,78,97
302,1,Neha,4,26,116,111,251,366,154,269,97,115
303,1,Neha,4,27,111,109,162,287,47,172,115,125
304,1,Neha,4,28,109,111,177,267,52,142,125,90
305,1,Neha,4,29,111,114,317,431,227,341,90,114
306,1,Neha,4,30,114,114,167,267,53,153,114,100
307,1,Neha,4,31,114,111,172,244,72,144,100,72
308,1,Neha,4,32,111,119,529,659,457,587,72,130
309,1,Neha,4,33,119,32,191,278,61,148,130,87
310,1,Neha,4,34,32,105,867,959,780,872,87,92
311,1,Neha,4,35,105,115,174,336,82,244,92,162
312,1,Neha,4,36,115,32,180,242,18,80,162,62
313,1,Neha,4,37,32,100,154,288,92,226,62,134
314,1,Neha,4,38,100,111,204,314,70,180,134,110
315,1,Neha,4,39,111,105,192,287,82,177,110,95
316,1,Neha,4,40,105,110,202,308,107,213,95,106
317,1,Neha,4,41,110,103,1302,1394,1196,1288,106,92
318,1,Neha,4,42,103,32,263,360,171,268,92,97
319,1,Neha,4,43,32,121,944,1039,847,942,97,95
320,1,Neha,4,44,121,111,513,599,418,504,95,86
321,1,Neha,4,45,111,117,224,297,138,211,86,73
322,1,Neha,4,46,117,114,458,586,385,513,73,128
323,1,Neha,4,47,114,32,164,265,36,137,128,101
324,1,Neha,4,48,32,98,259,360,158,259,101,101
325,1,Neha,4,49,98,101,318,408,217,307,101,90
326,1,Neha,4,50,101,115,141,293,51,203,90,152
327,1,Neha,4,51,115,116,169,256,17,104,152,87
328,1,Neha,4,52,116,32,247,349,160,262,87,102
329,1,Neha,4,53,32,116,320,483,218,381,102,163
330,1,Neha,4,54,116,111,206,319,43,156,163,113
331,1,Neha,4,55,111,100,649,731,536,618,113,82
332,1,Neha,4,56,100,97,115,278,33,196,82,163
333,1,Neha,4,57,97,121,352,448,189,285,163,96
666,3,Chinmayee,0,0,97,110,29,170,-229,-88,258,141
667,3,Chinmayee,0,1,110,121,993,1084,852,943,141,91
668,3,Chinmayee,0,2,121,32,330,444,239,353,91,114
669,3,Chinmayee,0,3,32,116,247,453,133,339,114,206
670,3,Chinmayee,0,4,116,114,133,301,-73,95,206,168
671,3,Chinmayee,0,5,114,97,356,561,188,393,168,205
672,3,Chinmayee,0,6,97,110,158,284,-47,79,205,126
673,3,Chinmayee,0,7,110,115,144,325,18,199,126,181
674,3,Chinmayee,0,8,115,105,164,289,-17,108,181,125
675,3,Chinmayee,0,9,105,116,365,524,240,399,125,159
676,3,Chinmayee,0,10,116,105,139,294,-20,135,159,155
677,3,Chinmayee,0,11,105,111,66,194,-89,39,155,128
678,3,Chinmayee,0,12,111,110,248,334,120,206,128,86
679,3,Chinmayee,0,13,110,32,136,246,50,160,86,110
680,3,Chinmayee,0,14,32,105,216,349,106,239,110,133
681,3,Chinmayee,0,15,105,115,102,278,-31,145,133,176
682,3,Chinmayee,0,16,115,32,194,304,18,128,176,110
683,3,Chinmayee,0,17,32,101,158,291,48,181,110,133
684,3,Chinmayee,0,18,101,97,235,522,102,389,133,287
685,3,Chinmayee,0,19,97,115,174,385,-113,98,287,211
686,3,Chinmayee,0,20,115,105,228,364,17,153,211,136
687,3,Chinmayee,0,21,105,101,223,373,87,237,136,150
688,3,Chinmayee,0,22,101,114,408,554,258,404,150,146
689,3,Chinmayee,0,23,114,32,356,486,210,340,146,130
690,3,Chinmayee,0,24,32,105,1212,1348,1082,1218,130,136
691,3,Chinmayee,0,25,105,102,106,279,-30,143,136,173
692,3,Chinmayee,0,26,102,32,144,217,-29,44,173,73
693,3,Chinmayee,0,27,32,121,810,928,737,855,73,118
694,3,Chinmayee,0,28,121,111,316,515,198,397,118,199
695,3,Chinmayee,0,29,111,117,129,277,-70,78,199,148
696,3,Chinmayee,0,30,117,32,307,433,159,285,148,126
697,3,Chinmayee,0,31,32,98,236,372,110,246,126,136
698,3,Chinmayee,0,32,98,101,86,274,-50,138,136,188
699,3,Chinmayee,0,33,101,108,325,409,137,221,188,84
700,3,Chinmayee,0,34,108,105,166,284,82,200,84,118
701,3,Chinmayee,0,35,105,101,199,397,81,279,118,198
702,3,Chinmayee,0,36,101,118,218,360,20,162,198,142
703,3,Chinmayee,0,37,118,101,93,315,-49,173,142,222
704,3,Chinmayee,0,38,101,32,205,333,-17,111,222,128
705,3,Chinmayee,0,39,32,105,941,1098,813,970,128,157
706,3,Chinmayee,0,40,105,110,187,325,30,168,157,138
707,3,Chinmayee,0,41,110,32,185,345,47,207,138,160
708,3,Chinmayee,0,42,32,121,581,709,421,549,160,128
709,3,Chinmayee,0,43,121,111,263,480,135,352,128,217
710,3,Chinmayee,0,44,111,117,817,936,600,719,217,119
711,3,Chinmayee,0,45,117,114,214,345,95,226,119,131
712,3,Chinmayee,0,46,114,115,318,546,187,415,131,228
713,3,Chinmayee,0,47,115,101,247,448,19,220,228,201
714,3,Chinmayee,0,48,101,108,221,332,20,131,201,111
715,3,Chinmayee,0,49,108,102,282,451,171,340,111,169
716,3,Chinmayee,0,50,102,32,191,311,22,142,169,120
717,3,Chinmayee,0,51,32,97,153,392,33,272,120,239
718,3,Chinmayee,0,52,97,110,159,271,-80,32,239,112
719,3,Chinmayee,0,53,110,100,154,352,42,240,112,198
720,3,Chinmayee,0,54,100,32,178,316,-20,118,198,138
721,3,Chinmayee,0,55,32,121,551,676,413,538,138,125
722,3,Chinmayee,0,56,121,111,302,466,177,341,125,164
723,3,Chinmayee,0,57,111,117,88,285,-76,121,164,197
724,3,Chinmayee,0,58,117,114,446,604,249,407,197,158
725,3,Chinmayee,0,59,114,32,383,551,225,393,158,168
726,3,Chinmayee,0,60,32,116,863,991,695,823,168,128
727,3,Chinmayee,0,61,116,97,96,295,-32,167,128,199
728,3,Chinmayee,0,62,97,108,415,550,216,351,199,135
729,3,Chinmayee,0,63,108,101,101,273,-34,138,135,172
730,3,Chinmayee,0,64,101,110,342,463,170,291,172,121
731,3,Chinmayee,0,65,110,116,163,323,42,202,121,160
732,3,Chinmayee,1,0,13,105,277,366,174,263,103,89
733,3,Chinmayee,1,1,105,116,253,356,164,267,89,103
734,3,Chinmayee,1,2,116,32,196,388,93,285,103,192
735,3,Chinmayee,1,3,32,100,113,233,-79,41,192,120
736,3,Chinmayee,1,4,100,111,138,302,18,182,120,164
737,3,Chinmayee,1,5,111,101,235,438,71,274,164,203
738,3,Chinmayee,1,6,101,115,150,287,-53,84,203,137
739,3,Chinmayee,1,7,115,32,380,559,243,422,137,179
740,3,Chinmayee,1,8,32,110,86,235,-93,56,179,149
741,3,Chinmayee,1,9,110,111,381,480,232,331,149,99
742,3,Chinmayee,1,10,111,116,254,345,155,246,99,91
743,3,Chinmayee,1,11,116,32,167,306,76,215,91,139
744,3,Chinmayee,1,12,32,109,90,313,-49,174,139,223
745,3,Chinmayee,1,13,109,97,269,369,46,146,223,100
746,3,Chinmayee,1,14,97,116,132,251,32,151,100,119
747,3,Chinmayee,1,15,116,116,139,287,20,168,119,148
748,3,Chinmayee,1,16,116,101,76,183,-72,35,148,107
749,3,Chinmayee,1,17,101,114,325,452,218,345,107,127
750,3,Chinmayee,1,18,114,32,607,792,480,665,127,185
751,3,Chinmayee,1,19,32,104,81,264,-104,79,185,183
752,3,Chinmayee,1,20,104,111,212,416,29,233,183,204
753,3,Chinmayee,1,21,111,119,254,343,50,139,204,89
754,3,Chinmayee,1,22,119,32,218,407,129,318,89,189
755,3,Chinmayee,1,23,32,115,98,223,-91,34,189,125
756,3,Chinmayee,1,24,115,108,164,309,39,184,125,145
757,3,Chinmayee,1,25,108,111,382,557,237,412,145,175
758,3,Chinmayee,1,26,111,119,207,320,32,145,175,113
759,3,Chinmayee,1,27,119,108,369,474,256,361,113,105
760,3,Chinmayee,1,28,108,121,277,386,172,281,105,109
761,3,Chinmayee,1,29,121,32,787,949,678,840,109,162
762,3,Chinmayee,1,30,32,121,254,485,92,323,162,231
763,3,Chinmayee,1,31,121,111,168,286,-63,55,231,118
764,3,Chinmayee,1,32,111,117,360,466,242,348,118,106
765,3,Chinmayee,1,33,117,32,357,478,251,372,106,121
766,3,Chinmayee,1,34,32,103,246,388,125,267,121,142
767,3,Chinmayee,1,35,103,111,570,651,428,509,142,81
768,3,Chinmayee,1,36,111,32,880,1171,799,1090,81,291
769,3,Chinmayee,1,37,32,97,197,428,-94,137,291,231
770,3,Chinmayee,1,38,97,115,361,471,130,240,231,110
771,3,Chinmayee,1,39,115,32,651,728,541,618,110,77
772,3,Chinmayee,1,40,32,108,138,262,61,185,77,124
773,3,Chinmayee,1,41,108,111,267,387,143,263,124,120
774,3,Chinmayee,1,42,111,110,242,341,122,221,120,99
775,3,Chinmayee,1,43,110,103,210,363,111,264,99,153
776,3,Chinmayee,1,44,103,32,121,362,-32,209,153,241
777,3,Chinmayee,1,45,32,97,122,379,-119,138,241,257
778,3,Chinmayee,1,46,97,115,198,301,-59,44,257,103
779,3,Chinmayee,1,47,115,32,793,908,690,805,103,115
780,3,Chinmayee,1,48,32,121,216,410,101,295,115,194
781,3,Chinmayee,1,49,121,111,145,274,-49,80,194,129
782,3,Chinmayee,1,50,111,117,298,412,169,283,129,114
783,3,Chinmayee,1,51,117,32,739,938,625,824,114,199
784,3,Chinmayee,1,52,32,100,131,249,-68,50,199,118
785,3,Chinmayee,1,53,100,111,783,907,665,789,118,124
786,3,Chinmayee,1,54,111,32,251,460,127,336,124,209
787,3,Chinmayee,1,55,32,110,95,250,-114,41,209,155
788,3,Chinmayee,1,56,110,111,350,462,195,307,155,112
789,3,Chinmayee,1,57,111,116,278,381,166,269,112,103
790,3,Chinmayee,1,58,116,32,392,563,289,460,103,171
791,3,Chinmayee,1,59,32,115,387,549,216,378,171,162
792,3,Chinmayee,1,60,115,116,228,427,66,265,162,199
793,3,Chinmayee,1,61,116,111,95,236,-104,37,199,141
794,3,Chinmayee,2,0,13,119,994,1174,908,1088,86,180
795,3,Chinmayee,2,1,119,101,66,264,-114,84,180,198
796,3,Chinmayee,2,2,101,32,132,245,-66,47,198,113
797,3,Chinmayee,2,3,32,107,290,368,177,255,113,78
798,3,Chinmayee,2,4,107,110,159,334,81,256,78,175
799,3,Chinmayee,2,5,110,111,104,249,-71,74,175,145
800,3,Chinmayee,2,6,111,119,362,546,217,401,145,184
801,3,Chinmayee,2,7,119,32,201,316,17,132,184,115
802,3,Chinmayee,2,8,32,119,1122,1331,1007,1216,115,209
803,3,Chinmayee,2,9,119,104,127,260,-82,51,209,133
804,3,Chinmayee,2,10,104,97,49,297,-84,164,133,248
805,3,Chinmayee,2,11,97,116,194,293,-54,45,248,99
806,3,Chinmayee,2,12,116,32,278,413,179,314,99,135
807,3,Chinmayee,2,13,32,119,313,521,178,386,135,208
808,3,Chinmayee,2,14,119,101,101,300,-107,92,208,199
809,3,Chinmayee,2,15,101,32,148,286,-51,87,199,138
810,3,Chinmayee,2,16,32,97,259,470,121,332,138,211
811,3,Chinmayee,2,17,97,114,484,604,273,393,211,120
812,3,Chinmayee,2,18,114,101,84,282,-36,162,120,198
813,3,Chinmayee,2,19,101,32,238,357,40,159,198,119
814,3,Chinmayee,2,20,32,98,623,841,504,722,119,218
815,3,Chinmayee,2,21,98,117,133,265,-85,47,218,132
816,3,Chinmayee,2,22,117,116,251,348,119,216,132,97
817,3,Chinmayee,2,23,116,32,214,323,117,226,97,109
818,3,Chinmayee,2,24,32,107,863,1004,754,895,109,141
819,3,Chinmayee,2,25,107,110,186,436,45,295,141,250
820,3,Chinmayee,2,26,110,111,151,300,-99,50,250,149
821,3,Chinmayee,2,27,111,119,284,464,135,315,149,180
822,3,Chinmayee,2,28,119,32,129,269,-51,89,180,140
823,3,Chinmayee,2,29,32,110,290,488,150,348,140,198
824,3,Chinmayee,2,30,110,111,103,259,-95,61,198,156
825,3,Chinmayee,2,31,111,116,358,462,202,306,156,104
826,3,Chinmayee,2,32,116,32,273,371,169,267,104,98
827,3,Chinmayee,2,33,32,119,166,384,68,286,98,218
828,3,Chinmayee,2,34,119,104,187,303,-31,85,218,116
829,3,Chinmayee,2,35,104,97,52,220,-64,104,116,168
830,3,Chinmayee,2,36,97,116,189,276,21,108,168,87
831,3,Chinmayee,2,37,116,32,371,506,284,419,87,135
832,3,Chinmayee,2,38,32,119,227,453,92,318,135,226
833,3,Chinmayee,2,39,119,101,109,301,-117,75,226,192
834,3,Chinmayee,2,40,101,32,102,229,-90,37,192,127
835,3,Chinmayee,2,41,32,109,349,522,222,395,127,173
836,3,Chinmayee,2,42,109,97,154,346,-19,173,173,192
837,3,Chinmayee,2,43,97,121,327,431,135,239,192,104
838,3,Chinmayee,2,44,121,32,298,417,194,313,104,119
839,3,Chinmayee,2,45,32,98,223,352,104,233,119,129
840,3,Chinmayee,2,46,98,101,79,229,-50,100,129,150
841,3,Chinmayee,3,0,13,121,1246,1354,1137,1245,109,108
842,3,Chinmayee,3,1,121,111,247,447,139,339,108,200
843,3,Chinmayee,3,2,111,117,142,279,-58,79,200,137
844,3,Chinmayee,3,3,117,32,485,575,348,438,137,90
845,3,Chinmayee,3,4,32,99,293,483,203,393,90,190
846,3,Chinmayee,3,5,99,97,97,296,-93,106,190,199
847,3,Chinmayee,3,6,97,110,152,260,-47,61,199,108
848,3,Chinmayee,3,7,110,116,309,498,201,390,108,189
849,3,Chinmayee,3,8,116,32,136,254,-53,65,189,118
850,3,Chinmayee,3,9,32,97,1356,1531,1238,1413,118,175
851,3,Chinmayee,3,10,97,108,101,242,-74,67,175,141
852,3,Chinmayee,3,11,108,119,226,416,85,275,141,190
853,3,Chinmayee,3,12,119,97,228,498,38,308,190,270
854,3,Chinmayee,3,13,97,121,150,271,-120,1,270,121
855,3,Chinmayee,3,14,121,115,71,274,-50,153,121,203
856,3,Chinmayee,3,15,115,32,247,352,44,149,203,105
857,3,Chinmayee,3,16,32,32,6419,6537,6314,6432,105,118
858,3,Chinmayee,3,17,32,104,286,428,168,310,118,142
859,3,Chinmayee,3,18,104,97,78,257,-64,115,142,179
860,3,Chinmayee,3,19,97,118,217,342,38,163,179,125
861,3,Chinmayee,3,20,118,101,91,253,-34,128,125,162
862,3,Chinmayee,3,21,101,32,196,317,34,155,162,121
863,3,Chinmayee,3,22,32,97,153,335,32,214,121,182
864,3,Chinmayee,3,23,97,32,119,275,-63,93,182,156
865,3,Chinmayee,3,24,32,103,1030,1166,874,1010,156,136
866,3,Chinmayee,3,25,103,111,212,315,76,179,136,103
867,3,Chinmayee,3,26,111,111,135,240,32,137,103,105
868,3,Chinmayee,3,27,111,100,199,408,94,303,105,209
869,3,Chinmayee,3,28,100,32,160,274,-49,65,209,114
870,3,Chinmayee,3,29,32,100,1219,1331,1105,1217,114,112
871,3,Chinmayee,3,30,100,97,97,289,-15,177,112,192
872,3,Chinmayee,3,31,97,121,241,343,49,151,192,102
873,3,Chinmayee,3,32,121,32,376,486,274,384,102,110
874,3,Chinmayee,3,33,32,98,981,1160,871,1050,110,179
875,3,Chinmayee,3,34,98,117,75,217,-104,38,179,142
876,3,Chinmayee,3,35,117,116,267,375,125,233,142,108
877,3,Chinmayee,3,36,116,32,391,524,283,416,108,133
878,3,Chinmayee,3,37,32,116,1253,1340,1120,1207,133,87
879,3,Chinmayee,3,38,116,8,363,521,276,434,87,158
880,3,Chinmayee,3,39,8,121,401,509,243,351,158,108
881,3,Chinmayee,3,40,121,111,181,405,73,297,108,224
882,3,Chinmayee,3,41,111,117,168,310,-56,86,224,142
883,3,Chinmayee,3,42,117,32,428,549,286,407,142,121
884,3,Chinmayee,3,43,32,99,569,780,448,659,121,211
885,3,Chinmayee,3,44,99,97,116,339,-95,128,211,223
886,3,Chinmayee,3,45,97,110,239,322,16,99,223,83
887,3,Chinmayee,3,46,110,32,417,513,334,430,83,96
888,3,Chinmayee,3,47,32,97,675,868,579,772,96,193
889,3,Chinmayee,3,48,97,108,231,350,38,157,193,119
890,3,Chinmayee,3,49,108,119,170,354,51,235,119,184
891,3,Chinmayee,3,50,119,97,125,457,-59,273,184,332
892,3,Chinmayee,3,51,97,121,198,311,-134,-21,332,113
893,3,Chinmayee,3,52,121,115,64,254,-49,141,113,190
894,3,Chinmayee,3,53,115,32,236,366,46,176,190,130
895,3,Chinmayee,3,54,32,102,994,1198,864,1068,130,204
896,3,Chinmayee,3,55,102,97,135,328,-69,124,204,193
897,3,Chinmayee,3,56,97,99,285,439,92,246,193,154
898,3,Chinmayee,3,57,99,101,105,289,-49,135,154,184
899,3,Chinmayee,3,58,101,32,138,264,-46,80,184,126
900,3,Chinmayee,3,59,32,97,149,353,23,227,126,204
901,3,Chinmayee,3,60,97,32,123,262,-81,58,204,139
902,3,Chinmayee,3,61,32,98,565,695,426,556,139,130
903,3,Chinmayee,3,62,98,97,65,261,-65,131,130,196
904,3,Chinmayee,3,63,97,100,316,489,120,293,196,173
905,3,Chinmayee,3,64,100,32,124,275,-49,102,173,151
906,3,Chinmayee,3,65,32,100,342,535,191,384,151,193
907,3,Chinmayee,3,66,100,97,61,263,-132,70,193,202
908,3,Chinmayee,3,67,97,121,218,333,16,131,202,115
909,3,Chinmayee,3,68,121,32,396,507,281,392,115,111
910,3,Chinmayee,3,69,32,119,751,950,640,839,111,199
911,3,Chinmayee,3,70,119,105,274,416,75,217,199,142
912,3,Chinmayee,3,71,105,116,306,464,164,322,142,158
913,3,Chinmayee,3,72,116,104,76,195,-82,37,158,119
914,3,Chinmayee,3,73,104,32,2888,3026,2769,2907,119,138
915,3,Chinmayee,3,74,32,97,158,338,20,200,138,180
916,3,Chinmayee,3,75,97,32,146,251,-34,71,180,105
917,3,Chinmayee,3,76,32,103,913,1052,808,947,105,139
918,3,Chinmayee,3,77,103,111,240,332,101,193,139,92
919,3,Chinmayee,3,78,111,111,131,276,39,184,92,145
920,3,Chinmayee,3,79,111,100,280,482,135,337,145,202
921,3,Chinmayee,3,80,100,32,171,269,-31,67,202,98
922,3,Chinmayee,3,81,32,97,954,1158,856,1060,98,204
923,3,Chinmayee,3,82,97,116,285,382,81,178,204,97
924,3,Chinmayee,3,83,116,116,114,219,17,122,97,105
925,3,Chinmayee,3,84,116,105,395,505,290,400,105,110
926,3,Chinmayee,3,85,105,116,352,461,242,351,110,109
927,3,Chinmayee,3,86,116,117,217,331,108,222,109,114
928,3,Chinmayee,3,87,117,100,358,614,244,500,114,256
929,3,Chinmayee,3,88,100,101,125,330,-131,74,256,205
930,3,Chinmayee,4,0,13,116,1011,1096,901,986,110,85
931,3,Chinmayee,4,1,116,104,166,276,81,191,85,110
932,3,Chinmayee,4,2,104,101,94,292,-16,182,110,198
933,3,Chinmayee,4,3,101,32,183,269,-15,71,198,86
934,3,Chinmayee,4,4,32,98,447,597,361,511,86,150
935,3,Chinmayee,4,5,98,101,118,292,-32,142,150,174
936,3,Chinmayee,4,6,101,115,279,455,105,281,174,176
937,3,Chinmayee,4,7,115,116,47,157,-129,-19,176,110
938,3,Chinmayee,4,8,116,32,344,466,234,356,110,122
939,3,Chinmayee,4,9,32,112,704,838,582,716,122,134
940,3,Chinmayee,4,10,112,114,102,302,-32,168,134,200
941,3,Chinmayee,4,11,114,101,62,262,-138,62,200,200
942,3,Chinmayee,4,12,101,112,107,220,-93,20,200,113
943,3,Chinmayee,4,13,112,114,447,536,334,423,113,89
944,3,Chinmayee,4,14,114,97,56,231,-33,142,89,175
945,3,Chinmayee,4,15,97,8,1468,1553,1293,1378,175,85
946,3,Chinmayee,4,16,8,8,121,212,36,127,85,91
947,3,Chinmayee,4,17,8,97,155,334,64,243,91,179
948,3,Chinmayee,4,18,97,114,488,597,309,418,179,109
949,3,Chinmayee,4,19,114,97,124,310,15,201,109,186
950,3,Chinmayee,4,20,97,116,136,237,-50,51,186,101
951,3,Chinmayee,4,21,116,105,478,636,377,535,101,158
952,3,Chinmayee,4,22,105,111,86,231,-72,73,158,145
953,3,Chinmayee,4,23,111,110,282,385,137,240,145,103
954,3,Chinmayee,4,24,110,32,176,286,73,183,103,110
955,3,Chinmayee,4,25,32,102,546,801,436,691,110,255
956,3,Chinmayee,4,26,102,111,174,302,-81,47,255,128
957,3,Chinmayee,4,27,111,114,48,145,-80,17,128,97
958,3,Chinmayee,4,28,114,32,497,607,400,510,97,110
959,3,Chinmayee,4,29,32,116,654,819,544,709,110,165
960,3,Chinmayee,4,30,116,111,115,245,-50,80,165,130
961,3,Chinmayee,4,31,111,109,229,414,99,284,130,185
962,3,Chinmayee,4,32,109,111,93,233,-92,48,185,140
963,3,Chinmayee,4,33,111,114,313,456,173,316,140,143
964,3,Chinmayee,4,34,114,114,176,309,33,166,143,133
965,3,Chinmayee,4,35,114,111,114,224,-19,91,133,110
966,3,Chinmayee,4,36,111,119,226,421,116,311,110,195
967,3,Chinmayee,4,37,119,32,146,278,-49,83,195,132
968,3,Chinmayee,4,38,32,105,245,386,113,254,132,141
969,3,Chinmayee,4,39,105,115,93,274,-48,133,141,181
970,3,Chinmayee,4,40,115,32,136,278,-45,97,181,142
971,3,Chinmayee,4,41,32,100,239,395,97,253,142,156
972,3,Chinmayee,4,42,100,111,104,244,-52,88,156,140
973,3,Chinmayee,4,43,111,105,219,319,79,179,140,100
974,3,Chinmayee,4,44,105,110,255,372,155,272,100,117
975,3,Chinmayee,4,45,110,103,197,341,80,224,117,144
976,3,Chinmayee,4,46,103,32,96,203,-48,59,144,107
977,3,Chinmayee,4,47,32,121,298,418,191,311,107,120
978,3,Chinmayee,4,48,121,111,247,397,127,277,120,150
979,3,Chinmayee,4,49,111,117,171,296,21,146,150,125
980,3,Chinmayee,4,50,117,101,333,434,208,309,125,101
981,3,Chinmayee,4,51,101,8,428,589,327,488,101,161
982,3,Chinmayee,4,52,8,114,125,271,-36,110,161,146
983,3,Chinmayee,4,53,114,32,208,338,62,192,146,130
984,3,Chinmayee,4,54,32,98,1058,1211,928,1081,130,153
985,3,Chinmayee,4,55,98,101,121,291,-32,138,153,170
986,3,Chinmayee,4,56,101,115,311,472,141,302,170,161
987,3,Chinmayee,4,57,115,116,63,192,-98,31,161,129
988,3,Chinmayee,4,58,116,32,322,455,193,326,129,133
989,3,Chinmayee,4,59,32,116,510,667,377,534,133,157
990,3,Chinmayee,4,60,116,111,191,303,34,146,157,112
991,3,Chinmayee,4,61,111,100,363,646,251,534,112,283
992,3,Chinmayee,4,62,100,97,155,374,-128,91,283,219
993,3,Chinmayee,4,63,97,121,175,265,-44,46,219,90
1365,5,Pavan,0,0,8,97,901,1036,817,952,84,135
1366,5,Pavan,0,1,97,110,1698,1832,1563,1697,135,134
1367,5,Pavan,0,2,110,121,101,251,-33,117,134,150
1368,5,Pavan,0,3,121,32,165,304,15,154,150,139
1369,5,Pavan,0,4,32,116,422,569,283,430,139,147
1370,5,Pavan,0,5,116,114,89,248,-58,101,147,159
1371,5,Pavan,0,6,114,110,379,503,220,344,159,124
1372,5,Pavan,0,7,110,97,188,339,64,215,124,151
1373,5,Pavan,0,8,97,115,216,408,65,257,151,192
1374,5,Pavan,0,9,115,105,176,345,-16,153,192,169
1375,5,Pavan,0,10,105,105,359,513,190,344,169,154
1376,5,Pavan,0,11,105,8,1440,1543,1286,1389,154,103
1377,5,Pavan,0,12,8,116,143,288,40,185,103,145
1378,5,Pavan,0,13,116,105,306,480,161,335,145,174
1379,5,Pavan,0,14,105,111,106,322,-68,148,174,216
1380,5,Pavan,0,15,111,110,186,296,-30,80,216,110
1381,5,Pavan,0,16,110,32,232,329,122,219,110,97
1382,5,Pavan,0,17,32,105,732,866,635,769,97,134
1383,5,Pavan,0,18,105,115,164,309,30,175,134,145
1384,5,Pavan,0,19,115,97,5422,5603,5277,5458,145,181
1385,5,Pavan,0,20,97,32,2038,2166,1857,1985,181,128
1386,5,Pavan,0,21,32,101,483,654,355,526,128,171
1387,5,Pavan,0,22,101,97,113,339,-58,168,171,226
1388,5,Pavan,0,23,97,115,335,512,109,286,226,177
1389,5,Pavan,0,24,115,105,128,336,-49,159,177,208
1390,5,Pavan,0,25,105,101,283,530,75,322,208,247
1391,5,Pavan,0,26,101,114,135,348,-112,101,247,213
1392,5,Pavan,0,27,114,8,3845,3961,3632,3748,213,116
1393,5,Pavan,0,28,8,32,2100,2196,1984,2080,116,96
1394,5,Pavan,0,29,32,105,539,663,443,567,96,124
1395,5,Pavan,0,30,105,102,104,244,-20,120,124,140
1396,5,Pavan,0,31,102,32,840,929,700,789,140,89
1397,5,Pavan,0,32,32,121,757,905,668,816,89,148
1398,5,Pavan,0,33,121,111,244,420,96,272,148,176
1399,5,Pavan,0,34,111,117,120,287,-56,111,176,167
1400,5,Pavan,0,35,117,32,434,549,267,382,167,115
1401,5,Pavan,0,36,32,98,464,579,349,464,115,115
1402,5,Pavan,0,37,98,101,204,347,89,232,115,143
1403,5,Pavan,0,38,101,108,402,573,259,430,143,171
1404,5,Pavan,0,39,108,105,113,293,-58,122,171,180
1405,5,Pavan,0,40,105,101,218,369,38,189,180,151
1406,5,Pavan,0,41,101,118,294,453,143,302,151,159
1407,5,Pavan,0,42,118,101,111,371,-48,212,159,260
1408,5,Pavan,0,43,101,32,277,424,17,164,260,147
1409,5,Pavan,0,44,32,105,830,1005,683,858,147,175
1410,5,Pavan,0,45,105,110,125,240,-50,65,175,115
1411,5,Pavan,0,46,110,32,179,332,64,217,115,153
1412,5,Pavan,0,47,32,121,370,519,217,366,153,149
1413,5,Pavan,0,48,121,111,396,595,247,446,149,199
1414,5,Pavan,0,49,111,117,131,293,-68,94,199,162
1415,5,Pavan,0,50,117,114,257,377,95,215,162,120
1416,5,Pavan,0,51,114,115,372,575,252,455,120,203
1417,5,Pavan,0,52,115,101,152,304,-51,101,203,152
1418,5,Pavan,0,53,101,108,209,344,57,192,152,135
1419,5,Pavan,0,54,108,103,244,374,109,239,135,130
1420,5,Pavan,0,55,103,8,701,833,571,703,130,132
1421,5,Pavan,0,56,8,102,117,275,-15,143,132,158
1422,5,Pavan,0,57,102,32,293,433,135,275,158,140
1423,5,Pavan,0,58,32,97,608,792,468,652,140,184
1424,5,Pavan,0,59,97,110,166,317,-18,133,184,151
1425,5,Pavan,0,60,110,100,169,308,18,157,151,139
1426,5,Pavan,0,61,100,32,155,320,16,181,139,165
1427,5,Pavan,0,62,32,121,457,590,292,425,165,133
1428,5,Pavan,0,63,121,111,165,457,32,324,133,292
1429,5,Pavan,0,64,111,117,327,480,35,188,292,153
1430,5,Pavan,0,65,117,114,186,321,33,168,153,135
1431,5,Pavan,0,66,114,32,501,627,366,492,135,126
1432,5,Pavan,0,67,32,116,405,547,279,421,126,142
1433,5,Pavan,0,68,116,97,580,729,438,587,142,149
1434,5,Pavan,0,69,97,108,192,366,43,217,149,174
1435,5,Pavan,0,70,108,101,210,374,36,200,174,164
1436,5,Pavan,0,71,101,110,207,354,43,190,164,147
1437,5,Pavan,0,72,110,116,180,323,33,176,147,143
1438,5,Pavan,1,0,13,105,1940,2065,1844,1969,96,125
1439,5,Pavan,1,1,105,116,105,224,-20,99,125,119
1440,5,Pavan,1,2,116,32,159,293,40,174,119,134
1441,5,Pavan,1,3,32,100,839,958,705,824,134,119
1442,5,Pavan,1,4,100,111,398,511,279,392,119,113
1443,5,Pavan,1,5,111,101,364,517,251,404,113,153
1444,5,Pavan,1,6,101,115,185,390,32,237,153,205
1445,5,Pavan,1,7,115,32,1905,2064,1700,1859,205,159
1446,5,Pavan,1,8,32,110,2474,2627,2315,2468,159,153
1447,5,Pavan,1,9,110,111,68,270,-85,117,153,202
1448,5,Pavan,1,10,111,116,162,304,-40,102,202,142
1449,5,Pavan,1,11,116,32,574,760,432,618,142,186
1450,5,Pavan,1,12,32,109,998,1110,812,924,186,112
1451,5,Pavan,1,13,109,97,258,395,146,283,112,137
1452,5,Pavan,1,14,97,116,488,619,351,482,137,131
1453,5,Pavan,1,15,116,116,161,250,30,119,131,89
1454,5,Pavan,1,16,116,101,216,403,127,314,89,187
1455,5,Pavan,1,17,101,114,99,270,-88,83,187,171
1456,5,Pavan,1,18,114,32,394,509,223,338,171,115
1457,5,Pavan,1,19,32,104,937,1072,822,957,115,135
1458,5,Pavan,1,20,104,111,72,209,-63,74,135,137
1459,5,Pavan,1,21,111,119,379,524,242,387,137,145
1460,5,Pavan,1,22,119,32,1326,1446,1181,1301,145,120
1461,5,Pavan,1,23,32,115,914,1048,794,928,120,134
1462,5,Pavan,1,24,115,108,256,347,122,213,134,91
1463,5,Pavan,1,25,108,111,182,282,91,191,91,100
1464,5,Pavan,1,26,111,119,205,318,105,218,100,113
1465,5,Pavan,1,27,119,108,241,358,128,245,113,117
1466,5,Pavan,1,28,108,121,628,767,511,650,117,139
1467,5,Pavan,1,29,121,32,313,433,174,294,139,120
1468,5,Pavan,1,30,32,121,965,1105,845,985,120,140
1469,5,Pavan,1,31,121,111,107,256,-33,116,140,149
1470,5,Pavan,1,32,111,117,178,315,29,166,149,137
1471,5,Pavan,1,33,117,32,176,316,39,179,137,140
1472,5,Pavan,1,34,32,103,372,517,232,377,140,145
1473,5,Pavan,1,35,103,111,228,386,83,241,145,158
1474,5,Pavan,1,36,111,32,178,306,20,148,158,128
1475,5,Pavan,1,37,32,97,183,423,55,295,128,240
1476,5,Pavan,1,38,97,115,172,336,-68,96,240,164
1477,5,Pavan,1,39,115,32,235,363,71,199,164,128
1478,5,Pavan,1,40,32,108,2634,2842,2506,2714,128,208
1479,5,Pavan,1,41,108,111,187,331,-21,123,208,144
1480,5,Pavan,1,42,111,109,179,301,35,157,144,122
1481,5,Pavan,1,43,109,8,813,914,691,792,122,101
1482,5,Pavan,1,44,8,110,367,500,266,399,101,133
1483,5,Pavan,1,45,110,103,187,337,54,204,133,150
1484,5,Pavan,1,46,103,32,130,282,-20,132,150,152
1485,5,Pavan,1,47,32,97,438,606,286,454,152,168
1486,5,Pavan,1,48,97,115,81,288,-87,120,168,207
1487,5,Pavan,1,49,115,32,335,483,128,276,207,148
1488,5,Pavan,1,50,32,121,1136,1291,988,1143,148,155
1489,5,Pavan,1,51,121,111,118,297,-37,142,155,179
1490,5,Pavan,1,52,111,117,200,355,21,176,179,155
1491,5,Pavan,1,53,117,32,268,391,113,236,155,123
1492,5,Pavan,1,54,32,100,697,828,574,705,123,131
1493,5,Pavan,1,55,100,111,735,873,604,742,131,138
1494,5,Pavan,1,56,111,32,238,344,100,206,138,106
1495,5,Pavan,1,57,32,110,208,389,102,283,106,181
1496,5,Pavan,1,58,110,111,129,302,-52,121,181,173
1497,5,Pavan,1,59,111,116,189,328,16,155,173,139
1498,5,Pavan,1,60,116,32,119,261,-20,122,139,142
1499,5,Pavan,1,61,32,115,349,489,207,347,142,140
1500,5,Pavan,1,62,115,116,304,456,164,316,140,152
1501,5,Pavan,1,63,116,111,376,609,224,457,152,233
1502,5,Pavan,1,64,111,112,47,322,-186,89,233,275
1503,5,Pavan,2,0,13,119,964,1117,856,1009,108,153
1504,5,Pavan,2,1,119,101,79,255,-74,102,153,176
1505,5,Pavan,2,2,101,32,190,320,14,144,176,130
1506,5,Pavan,2,3,32,107,814,1031,684,901,130,217
1507,5,Pavan,2,4,107,110,112,260,-105,43,217,148
1508,5,Pavan,2,5,110,111,441,601,293,453,148,160
1509,5,Pavan,2,6,111,101,193,301,33,141,160,108
1510,5,Pavan,2,7,101,8,661,825,553,717,108,164
1511,5,Pavan,2,8,8,119,127,268,-37,104,164,141
1512,5,Pavan,2,9,119,32,242,366,101,225,141,124
1513,5,Pavan,2,10,32,119,760,881,636,757,124,121
1514,5,Pavan,2,11,119,104,245,355,124,234,121,110
1515,5,Pavan,2,12,104,97,141,298,31,188,110,157
1516,5,Pavan,2,13,97,116,272,423,115,266,157,151
1517,5,Pavan,2,14,116,32,244,364,93,213,151,120
1518,5,Pavan,2,15,32,119,1475,1619,1355,1499,120,144
1519,5,Pavan,2,16,119,101,81,260,-63,116,144,179
1520,5,Pavan,2,17,101,32,213,362,34,183,179,149
1521,5,Pavan,2,18,32,97,504,675,355,526,149,171
1522,5,Pavan,2,19,97,114,433,691,262,520,171,258
1523,5,Pavan,2,20,114,101,203,358,-55,100,258,155
1524,5,Pavan,2,21,101,32,117,311,-38,156,155,194
1525,5,Pavan,2,22,32,98,819,984,625,790,194,165
1526,5,Pavan,2,23,98,117,72,265,-93,100,165,193
1527,5,Pavan,2,24,117,116,162,333,-31,140,193,171
1528,5,Pavan,2,25,116,32,361,508,190,337,171,147
1529,5,Pavan,2,26,32,107,1173,1366,1026,1219,147,193
1530,5,Pavan,2,27,107,110,68,271,-125,78,193,203
1531,5,Pavan,2,28,110,111,311,474,108,271,203,163
1532,5,Pavan,2,29,111,119,294,439,131,276,163,145
1533,5,Pavan,2,30,119,32,262,391,117,246,145,129
1534,5,Pavan,2,31,32,110,962,1144,833,1015,129,182
1535,5,Pavan,2,32,110,111,114,286,-68,104,182,172
1536,5,Pavan,2,33,111,116,289,431,117,259,172,142
1537,5,Pavan,2,34,116,32,415,519,273,377,142,104
1538,5,Pavan,2,35,32,119,1157,1298,1053,1194,104,141
1539,5,Pavan,2,36,119,104,241,395,100,254,141,154
1540,5,Pavan,2,37,104,97,132,287,-22,133,154,155
1541,5,Pavan,2,38,97,116,347,504,192,349,155,157
1542,5,Pavan,2,39,116,32,238,335,81,178,157,97
1543,5,Pavan,2,40,32,119,527,684,430,587,97,157
1544,5,Pavan,2,41,119,101,108,290,-49,133,157,182
1545,5,Pavan,2,42,101,32,135,297,-47,115,182,162
1546,5,Pavan,2,43,32,109,260,390,98,228,162,130
1547,5,Pavan,2,44,109,97,164,302,34,172,130,138
1548,5,Pavan,2,45,97,121,393,495,255,357,138,102
1549,5,Pavan,2,46,121,32,196,362,94,260,102,166
1550,5,Pavan,2,47,32,98,349,484,183,318,166,135
1551,5,Pavan,2,48,98,101,198,327,63,192,135,129
1552,5,Pavan,3,0,13,121,1497,1644,1300,1447,197,147
1553,5,Pavan,3,1,121,111,167,349,20,202,147,182
1554,5,Pavan,3,2,111,117,198,331,16,149,182,133
1555,5,Pavan,3,3,117,32,164,301,31,168,133,137
1556,5,Pavan,3,4,32,99,585,771,448,634,137,186
1557,5,Pavan,3,5,99,97,94,258,-92,72,186,164
1558,5,Pavan,3,6,97,110,206,344,42,180,164,138
1559,5,Pavan,3,7,110,116,1291,1407,1153,1269,138,116
1560,5,Pavan,3,8,116,32,304,418,188,302,116,114
1561,5,Pavan,3,9,32,97,368,502,254,388,114,134
1562,5,Pavan,3,10,97,108,589,695,455,561,134,106
1563,5,Pavan,3,11,108,119,238,470,132,364,106,232
1564,5,Pavan,3,12,119,97,184,355,-48,123,232,171
1565,5,Pavan,3,13,97,121,1630,1800,1459,1629,171,170
1566,5,Pavan,3,14,121,115,201,322,31,152,170,121
1567,5,Pavan,3,15,115,32,182,335,61,214,121,153
1568,5,Pavan,3,16,32,104,866,1003,713,850,153,137
1569,5,Pavan,3,17,104,97,104,286,-33,149,137,182
1570,5,Pavan,3,18,97,118,221,362,39,180,182,141
1571,5,Pavan,3,19,118,101,380,534,239,393,141,154
1572,5,Pavan,3,20,101,32,246,391,92,237,154,145
1573,5,Pavan,3,21,32,97,184,352,39,207,145,168
1574,5,Pavan,3,22,97,32,186,297,18,129,168,111
1575,5,Pavan,3,23,32,103,555,717,444,606,111,162
1576,5,Pavan,3,24,103,111,275,374,113,212,162,99
1577,5,Pavan,3,25,111,111,130,239,31,140,99,109
1578,5,Pavan,3,26,111,100,155,302,46,193,109,147
1579,5,Pavan,3,27,100,32,212,356,65,209,147,144
1580,5,Pavan,3,28,32,100,261,456,117,312,144,195
1581,5,Pavan,3,29,100,97,146,335,-49,140,195,189
1582,5,Pavan,3,30,97,121,401,582,212,393,189,181
1583,5,Pavan,3,31,121,32,197,337,16,156,181,140
1584,5,Pavan,3,32,32,98,1593,1708,1453,1568,140,115
1585,5,Pavan,3,33,98,117,48,247,-67,132,115,199
1586,5,Pavan,3,34,117,116,237,399,38,200,199,162
1587,5,Pavan,3,35,116,32,192,329,30,167,162,137
1588,5,Pavan,3,36,32,121,896,1047,759,910,137,151
1589,5,Pavan,3,37,121,111,170,361,19,210,151,191
1590,5,Pavan,3,38,111,117,120,251,-71,60,191,131
1591,5,Pavan,3,39,117,32,316,445,185,314,131,129
1592,5,Pavan,3,40,32,99,389,580,260,451,129,191
1593,5,Pavan,3,41,99,97,212,403,21,212,191,191
1594,5,Pavan,3,42,97,110,209,328,18,137,191,119
1595,5,Pavan,3,43,110,32,523,643,404,524,119,120
1596,5,Pavan,3,44,32,97,570,725,450,605,120,155
1597,5,Pavan,3,45,97,108,222,416,67,261,155,194
1598,5,Pavan,3,46,108,119,334,510,140,316,194,176
1599,5,Pavan,3,47,119,97,127,324,-49,148,176,197
1600,5,Pavan,3,48,97,121,517,639,320,442,197,122
1601,5,Pavan,3,49,121,115,459,610,337,488,122,151
1602,5,Pavan,3,50,115,32,185,352,34,201,151,167
1603,5,Pavan,3,51,32,102,861,1006,694,839,167,145
1604,5,Pavan,3,52,102,97,166,324,21,179,145,158
1605,5,Pavan,3,53,97,99,109,252,-49,94,158,143
1606,5,Pavan,3,54,99,101,228,386,85,243,143,158
1607,5,Pavan,3,55,101,32,191,326,33,168,158,135
1608,5,Pavan,3,56,32,97,167,346,32,211,135,179
1609,5,Pavan,3,57,97,32,281,374,102,195,179,93
1610,5,Pavan,3,58,32,98,300,425,207,332,93,125
1611,5,Pavan,3,59,98,97,230,468,105,343,125,238
1612,5,Pavan,3,60,97,100,608,748,370,510,238,140
1613,5,Pavan,3,61,100,32,353,516,213,376,140,163
1614,5,Pavan,3,62,32,100,635,829,472,666,163,194
1615,5,Pavan,3,63,100,97,130,317,-64,123,194,187
1616,5,Pavan,3,64,97,121,203,370,16,183,187,167
1617,5,Pavan,3,65,121,32,239,372,72,205,167,133
1618,5,Pavan,3,66,32,119,845,980,712,847,133,135
1619,5,Pavan,3,67,119,105,283,414,148,279,135,131
1620,5,Pavan,3,68,105,116,172,314,41,183,131,142
1621,5,Pavan,3,69,116,104,175,281,33,139,142,106
1622,5,Pavan,3,70,104,32,232,379,126,273,106,147
1623,5,Pavan,3,71,32,97,168,313,21,166,147,145
1624,5,Pavan,3,72,97,32,181,335,36,190,145,154
1625,5,Pavan,3,73,32,103,185,316,31,162,154,131
1626,5,Pavan,3,74,103,111,258,360,127,229,131,102
1627,5,Pavan,3,75,111,111,157,277,55,175,102,120
1628,5,Pavan,3,76,111,100,180,312,60,192,120,132
1629,5,Pavan,3,77,100,32,218,331,86,199,132,113
1630,5,Pavan,3,78,32,97,297,442,184,329,113,145
1631,5,Pavan,3,79,97,116,294,434,149,289,145,140
1632,5,Pavan,3,80,116,116,180,308,40,168,140,128
1633,5,Pavan,3,81,116,105,108,259,-20,131,128,151
1634,5,Pavan,3,82,105,116,168,297,17,146,151,129
1635,5,Pavan,3,83,116,117,160,300,31,171,129,140
1636,5,Pavan,3,84,117,100,1803,2003,1663,1863,140,200
1637,5,Pavan,3,85,100,101,132,293,-68,93,200,161
1638,5,Pavan,4,0,13,116,1268,1409,1157,1298,111,141
1639,5,Pavan,4,1,116,104,109,288,-32,147,141,179
1640,5,Pavan,4,2,104,101,286,408,107,229,179,122
1641,5,Pavan,4,3,101,32,141,301,19,179,122,160
1642,5,Pavan,4,4,32,98,279,411,119,251,160,132
1643,5,Pavan,4,5,98,101,153,265,21,133,132,112
1644,5,Pavan,4,6,101,116,412,581,300,469,112,169
1645,5,Pavan,4,7,116,115,51,209,-118,40,169,158
1646,5,Pavan,4,8,115,8,1592,1740,1434,1582,158,148
1647,5,Pavan,4,9,8,8,178,317,30,169,148,139
1648,5,Pavan,4,10,8,115,538,643,399,504,139,105
1649,5,Pavan,4,11,115,116,210,395,105,290,105,185
1650,5,Pavan,4,12,116,32,218,361,33,176,185,143
1651,5,Pavan,4,13,32,112,637,729,494,586,143,92
1652,5,Pavan,4,14,112,114,259,431,167,339,92,172
1653,5,Pavan,4,15,114,101,123,261,-49,89,172,138
1654,5,Pavan,4,16,101,112,490,594,352,456,138,104
1655,5,Pavan,4,17,112,101,145,284,41,180,104,139
1656,5,Pavan,4,18,101,114,261,384,122,245,139,123
1657,5,Pavan,4,19,114,97,427,558,304,435,123,131
1658,5,Pavan,4,20,97,116,263,431,132,300,131,168
1659,5,Pavan,4,21,116,105,789,1014,621,846,168,225
1660,5,Pavan,4,22,105,111,146,375,-79,150,225,229
1661,5,Pavan,4,23,111,110,1083,1247,854,1018,229,164
1662,5,Pavan,4,24,110,32,311,470,147,306,164,159
1663,5,Pavan,4,25,32,102,1100,1247,941,1088,159,147
1664,5,Pavan,4,26,102,111,191,375,44,228,147,184
1665,5,Pavan,4,27,111,114,253,417,69,233,184,164
1666,5,Pavan,4,28,114,32,244,392,80,228,164,148
1667,5,Pavan,4,29,32,116,219,390,71,242,148,171
1668,5,Pavan,4,30,116,111,326,507,155,336,171,181
1669,5,Pavan,4,31,111,109,280,384,99,203,181,104
1670,5,Pavan,4,32,109,109,162,298,58,194,104,136
1671,5,Pavan,4,33,109,111,167,309,31,173,136,142
1672,5,Pavan,4,34,111,114,269,417,127,275,142,148
1673,5,Pavan,4,35,114,111,167,301,19,153,148,134
1674,5,Pavan,4,36,111,119,420,549,286,415,134,129
1675,5,Pavan,4,37,119,32,242,376,113,247,129,134
1676,5,Pavan,4,38,32,105,598,773,464,639,134,175
1677,5,Pavan,4,39,105,115,259,392,84,217,175,133
1678,5,Pavan,4,40,115,32,168,311,35,178,133,143
1679,5,Pavan,4,41,32,100,175,318,32,175,143,143
1680,5,Pavan,4,42,100,111,219,463,76,320,143,244
1681,5,Pavan,4,43,111,105,192,301,-52,57,244,109
1682,5,Pavan,4,44,105,110,313,445,204,336,109,132
1683,5,Pavan,4,45,110,32,262,397,130,265,132,135
1684,5,Pavan,4,46,32,121,972,1133,837,998,135,161
1685,5,Pavan,4,47,121,111,219,431,58,270,161,212
1686,5,Pavan,4,48,111,117,248,387,36,175,212,139
1687,5,Pavan,4,49,117,114,520,669,381,530,139,149
1688,5,Pavan,4,50,114,32,319,467,170,318,149,148
1689,5,Pavan,4,51,32,98,523,646,375,498,148,123
1690,5,Pavan,4,52,98,101,233,361,110,238,123,128
1691,5,Pavan,4,53,101,115,255,382,127,254,128,127
1692,5,Pavan,4,54,115,116,234,374,107,247,127,140
1693,5,Pavan,4,55,116,32,441,565,301,425,140,124
1694,5,Pavan,4,56,32,116,376,520,252,396,124,144
1695,5,Pavan,4,57,116,111,267,393,123,249,144,126
1696,5,Pavan,4,58,111,100,484,691,358,565,126,207
1697,5,Pavan,4,59,100,97,146,335,-61,128,207,189
1698,5,Pavan,4,60,97,121,140,296,-49,107,189,156
1699,5,Pavan,4,61,121,8,5952,6038,5796,5882,156,86
1700,5,Pavan,4,62,8,114,3383,3530,3297,3444,86,147
1701,5,Pavan,4,63,114,103,5549,5704,5402,5557,147,155
1702,5,Pavan,4,64,103,8,8305,8485,8150,8330,155,180
1703,5,Pavan,4,65,8,97,131,276,-49,96,180,145
1704,6,Aniket,0,0,97,110,241,430,103,292,138,189
1705,6,Aniket,0,1,110,121,273,405,84,216,189,132
1706,6,Aniket,0,2,121,32,2325,2458,2193,2326,132,133
1707,6,Aniket,0,3,32,116,694,823,561,690,133,129
1708,6,Aniket,0,4,116,114,168,292,39,163,129,124
1709,6,Aniket,0,5,114,97,187,339,63,215,124,152
1710,6,Aniket,0,6,97,110,1785,1893,1633,1741,152,108
1711,6,Aniket,0,7,110,115,403,534,295,426,108,131
1712,6,Aniket,0,8,115,105,250,374,119,243,131,124
1713,6,Aniket,0,9,105,116,519,646,395,522,124,127
1714,6,Aniket,0,10,116,105,198,397,71,270,127,199
1715,6,Aniket,0,11,105,111,837,955,638,756,199,118
1716,6,Aniket,0,12,111,110,298,406,180,288,118,108
1717,6,Aniket,0,13,110,32,719,858,611,750,108,139
1718,6,Aniket,0,14,32,105,673,788,534,649,139,115
1719,6,Aniket,0,15,105,115,244,368,129,253,115,124
1720,6,Aniket,0,16,115,32,178,310,54,186,124,132
1721,6,Aniket,0,17,32,101,402,516,270,384,132,114
1722,6,Aniket,0,18,101,97,152,299,38,185,114,147
1723,6,Aniket,0,19,97,115,278,415,131,268,147,137
1724,6,Aniket,0,20,115,105,332,456,195,319,137,124
1725,6,Aniket,0,21,105,101,319,452,195,328,124,133
1726,6,Aniket,0,22,101,114,151,260,18,127,133,109
1727,6,Aniket,0,23,114,32,405,536,296,427,109,131
1728,6,Aniket,0,24,32,105,1074,1181,943,1050,131,107
1729,6,Aniket,0,25,105,102,273,395,166,288,107,122
1730,6,Aniket,0,26,102,32,160,285,38,163,122,125
1731,6,Aniket,0,27,32,121,362,467,237,342,125,105
1732,6,Aniket,0,28,121,111,580,692,475,587,105,112
1733,6,Aniket,0,29,111,117,172,298,60,186,112,126
1734,6,Aniket,0,30,117,32,273,397,147,271,126,124
1735,6,Aniket,0,31,32,98,554,652,430,528,124,98
1736,6,Aniket,0,32,98,101,175,306,77,208,98,131
1737,6,Aniket,0,33,101,108,322,450,191,319,131,128
1738,6,Aniket,0,34,108,105,236,336,108,208,128,100
1739,6,Aniket,0,35,105,101,201,371,101,271,100,170
1740,6,Aniket,0,36,101,118,430,540,260,370,170,110
1741,6,Aniket,0,37,118,101,147,283,37,173,110,136
1742,6,Aniket,0,38,101,32,499,622,363,486,136,123
1743,6,Aniket,0,39,32,105,553,680,430,557,123,127
1744,6,Aniket,0,40,105,110,210,324,83,197,127,114
1745,6,Aniket,0,41,110,32,204,325,90,211,114,121
1746,6,Aniket,0,42,32,121,569,710,448,589,121,141
1747,6,Aniket,0,43,121,111,205,330,64,189,141,125
1748,6,Aniket,0,44,111,117,635,751,510,626,125,116
1749,6,Aniket,0,45,117,114,210,331,94,215,116,121
1750,6,Aniket,0,46,114,115,557,720,436,599,121,163
1751,6,Aniket,0,47,115,101,277,450,114,287,163,173
1752,6,Aniket,0,48,101,108,376,505,203,332,173,129
1753,6,Aniket,0,49,108,102,200,316,71,187,129,116
1754,6,Aniket,0,50,102,32,628,744,512,628,116,116
1755,6,Aniket,0,51,32,97,596,759,480,643,116,163
1756,6,Aniket,0,52,97,110,394,503,231,340,163,109
1757,6,Aniket,0,53,110,100,142,268,33,159,109,126
1758,6,Aniket,0,54,100,32,158,276,32,150,126,118
1759,6,Aniket,0,55,32,121,733,843,615,725,118,110
1760,6,Aniket,0,56,121,111,226,350,116,240,110,124
1761,6,Aniket,0,57,111,117,238,348,114,224,124,110
1762,6,Aniket,0,58,117,114,318,458,208,348,110,140
1763,6,Aniket,0,59,114,32,208,336,68,196,140,128
1764,6,Aniket,0,60,32,116,292,407,164,279,128,115
1765,6,Aniket,0,61,116,97,222,393,107,278,115,171
1766,6,Aniket,0,62,97,108,311,435,140,264,171,124
1767,6,Aniket,0,63,108,101,173,354,49,230,124,181
1768,6,Aniket,0,64,101,110,239,356,58,175,181,117
1769,6,Aniket,0,65,110,116,557,698,440,581,117,141
1770,6,Aniket,1,0,13,105,1634,1749,1534,1649,100,115
1771,6,Aniket,1,1,105,116,208,349,93,234,115,141
1772,6,Aniket,1,2,116,32,188,309,47,168,141,121
1773,6,Aniket,1,3,32,100,586,729,465,608,121,143
1774,6,Aniket,1,4,100,111,219,326,76,183,143,107
1775,6,Aniket,1,5,111,101,325,473,218,366,107,148
1776,6,Aniket,1,6,101,115,312,421,164,273,148,109
1777,6,Aniket,1,7,115,32,205,340,96,231,109,135
1778,6,Aniket,1,8,32,110,971,1075,836,940,135,104
1779,6,Aniket,1,9,110,111,506,614,402,510,104,108
1780,6,Aniket,1,10,111,116,148,272,40,164,108,124
1781,6,Aniket,1,11,116,32,180,314,56,190,124,134
1782,6,Aniket,1,12,32,109,285,408,151,274,134,123
1783,6,Aniket,1,13,109,97,476,642,353,519,123,166
1784,6,Aniket,1,14,97,116,240,365,74,199,166,125
1785,6,Aniket,1,15,116,116,180,321,55,196,125,141
1786,6,Aniket,1,16,116,101,238,377,97,236,141,139
1787,6,Aniket,1,17,101,114,157,269,18,130,139,112
1788,6,Aniket,1,18,114,32,609,739,497,627,112,130
1789,6,Aniket,1,19,32,104,1477,1603,1347,1473,130,126
1790,6,Aniket,1,20,104,111,642,757,516,631,126,115
1791,6,Aniket,1,21,111,119,240,389,125,274,115,149
1792,6,Aniket,1,22,119,32,254,388,105,239,149,134
1793,6,Aniket,1,23,32,115,1418,1573,1284,1439,134,155
1794,6,Aniket,1,24,115,108,209,335,54,180,155,126
1795,6,Aniket,1,25,108,111,201,298,75,172,126,97
1796,6,Aniket,1,26,111,119,240,383,143,286,97,143
1797,6,Aniket,1,27,119,108,250,384,107,241,143,134
1798,6,Aniket,1,28,108,121,469,554,335,420,134,85
1799,6,Aniket,1,29,121,32,153,277,68,192,85,124
1800,6,Aniket,1,30,32,121,1142,1270,1018,1146,124,128
1801,6,Aniket,1,31,121,111,226,349,98,221,128,123
1802,6,Aniket,1,32,111,117,202,317,79,194,123,115
1803,6,Aniket,1,33,117,32,147,269,32,154,115,122
1804,6,Aniket,1,34,32,103,512,672,390,550,122,160
1805,6,Aniket,1,35,103,111,212,293,52,133,160,81
1806,6,Aniket,1,36,111,32,338,434,257,353,81,96
1807,6,Aniket,1,37,32,97,911,1048,815,952,96,137
1808,6,Aniket,1,38,97,115,262,396,125,259,137,134
1809,6,Aniket,1,39,115,32,199,326,65,192,134,127
1810,6,Aniket,1,40,32,108,639,764,512,637,127,125
1811,6,Aniket,1,41,108,111,196,296,71,171,125,100
1812,6,Aniket,1,42,111,110,234,354,134,254,100,120
1813,6,Aniket,1,43,110,103,274,385,154,265,120,111
1814,6,Aniket,1,44,103,32,154,277,43,166,111,123
1815,6,Aniket,1,45,32,97,833,951,710,828,123,118
1816,6,Aniket,1,46,97,115,229,362,111,244,118,133
1817,6,Aniket,1,47,115,32,327,451,194,318,133,124
1818,6,Aniket,1,48,32,121,769,891,645,767,124,122
1819,6,Aniket,1,49,121,111,354,471,232,349,122,117
1820,6,Aniket,1,50,111,117,208,341,91,224,117,133
1821,6,Aniket,1,51,117,32,164,283,31,150,133,119
1822,6,Aniket,1,52,32,100,561,696,442,577,119,135
1823,6,Aniket,1,53,100,111,278,405,143,270,135,127
1824,6,Aniket,1,54,111,32,621,720,494,593,127,99
1825,6,Aniket,1,55,32,110,510,636,411,537,99,126
1826,6,Aniket,1,56,110,111,464,562,338,436,126,98
1827,6,Aniket,1,57,111,116,137,265,39,167,98,128
1828,6,Aniket,1,58,116,32,183,316,55,188,128,133
1829,6,Aniket,1,59,32,115,470,596,337,463,133,126
1830,6,Aniket,1,60,115,116,271,411,145,285,126,140
1831,6,Aniket,1,61,116,111,288,475,148,335,140,187
1832,6,Aniket,1,62,111,112,145,286,-42,99,187,141
1833,6,Aniket,2,0,13,119,1042,1188,950,1096,92,146
1834,6,Aniket,2,1,119,101,222,361,76,215,146,139
1835,6,Aniket,2,2,101,32,232,352,93,213,139,120
1836,6,Aniket,2,3,32,107,451,564,331,444,120,113
1837,6,Aniket,2,4,107,110,206,316,93,203,113,110
1838,6,Aniket,2,5,110,111,537,640,427,530,110,103
1839,6,Aniket,2,6,111,119,282,407,179,304,103,125
1840,6,Aniket,2,7,119,119,1127,1262,1002,1137,125,135
1841,6,Aniket,2,8,119,104,186,310,51,175,135,124
1842,6,Aniket,2,9,104,97,154,386,30,262,124,232
1843,6,Aniket,2,10,97,116,183,301,-49,69,232,118
1844,6,Aniket,2,11,116,32,309,443,191,325,118,134
1845,6,Aniket,2,12,32,8,979,1085,845,951,134,106
1846,6,Aniket,2,13,8,8,183,274,77,168,106,91
1847,6,Aniket,2,14,8,8,173,285,82,194,91,112
1848,6,Aniket,2,15,8,8,198,315,86,203,112,117
1849,6,Aniket,2,16,8,8,196,288,79,171,117,92
1850,6,Aniket,2,17,8,32,2188,2360,2096,2268,92,172
1851,6,Aniket,2,18,32,119,642,793,470,621,172,151
1852,6,Aniket,2,19,119,104,212,338,61,187,151,126
1853,6,Aniket,2,20,104,97,501,598,375,472,126,97
1854,6,Aniket,2,21,97,116,353,468,256,371,97,115
1855,6,Aniket,2,22,116,32,670,789,555,674,115,119
1856,6,Aniket,2,23,32,119,491,626,372,507,119,135
1857,6,Aniket,2,24,119,101,225,355,90,220,135,130
1858,6,Aniket,2,25,101,32,480,624,350,494,130,144
1859,6,Aniket,2,26,32,97,188,359,44,215,144,171
1860,6,Aniket,2,27,97,114,217,344,46,173,171,127
1861,6,Aniket,2,28,114,101,166,319,39,192,127,153
1862,6,Aniket,2,29,101,32,310,456,157,303,153,146
1863,6,Aniket,2,30,32,98,943,1063,797,917,146,120
1864,6,Aniket,2,31,98,117,338,450,218,330,120,112
1865,6,Aniket,2,32,117,116,173,294,61,182,112,121
1866,6,Aniket,2,33,116,32,157,284,36,163,121,127
1867,6,Aniket,2,34,32,107,1421,1546,1294,1419,127,125
1868,6,Aniket,2,35,107,110,233,363,108,238,125,130
1869,6,Aniket,2,36,110,111,337,458,207,328,130,121
1870,6,Aniket,2,37,111,119,306,421,185,300,121,115
1871,6,Aniket,2,38,119,32,208,326,93,211,115,118
1872,6,Aniket,2,39,32,110,1232,1349,1114,1231,118,117
1873,6,Aniket,2,40,110,111,405,527,288,410,117,122
1874,6,Aniket,2,41,111,116,223,347,101,225,122,124
1875,6,Aniket,2,42,116,32,185,312,61,188,124,127
1876,6,Aniket,2,43,32,119,733,895,606,768,127,162
1877,6,Aniket,2,44,119,104,146,287,-16,125,162,141
1878,6,Aniket,2,45,104,97,246,414,105,273,141,168
1879,6,Aniket,2,46,97,116,116,226,-52,58,168,110
1880,6,Aniket,2,47,116,32,768,873,658,763,110,105
1881,6,Aniket,2,48,32,119,2948,3104,2843,2999,105,156
1882,6,Aniket,2,49,119,101,251,374,95,218,156,123
1883,6,Aniket,2,50,101,32,296,387,173,264,123,91
1884,6,Aniket,2,51,32,109,569,685,478,594,91,116
1885,6,Aniket,2,52,109,97,179,324,63,208,116,145
1886,6,Aniket,2,53,97,121,206,306,61,161,145,100
1887,6,Aniket,2,54,121,32,235,368,135,268,100,133
1888,6,Aniket,2,55,32,98,320,426,187,293,133,106
1889,6,Aniket,2,56,98,101,136,265,30,159,106,129
1890,6,Aniket,3,0,13,121,1228,1337,1124,1233,104,109
1891,6,Aniket,3,1,121,111,391,510,282,401,109,119
1892,6,Aniket,3,2,111,117,175,299,56,180,119,124
1893,6,Aniket,3,3,117,32,188,312,64,188,124,124
1894,6,Aniket,3,4,32,99,665,900,541,776,124,235
1895,6,Aniket,3,5,99,97,186,484,-49,249,235,298
1896,6,Aniket,3,6,97,116,662,786,364,488,298,124
1897,6,Aniket,3,7,116,8,804,944,680,820,124,140
1898,6,Aniket,3,8,8,110,476,595,336,455,140,119
1899,6,Aniket,3,9,110,116,172,300,53,181,119,128
1900,6,Aniket,3,10,116,32,294,420,166,292,128,126
1901,6,Aniket,3,11,32,97,966,1116,840,990,126,150
1902,6,Aniket,3,12,97,108,311,425,161,275,150,114
1903,6,Aniket,3,13,108,119,183,350,69,236,114,167
1904,6,Aniket,3,14,119,97,248,409,81,242,167,161
1905,6,Aniket,3,15,97,121,221,341,60,180,161,120
1906,6,Aniket,3,16,121,115,162,326,42,206,120,164
1907,6,Aniket,3,17,115,32,520,631,356,467,164,111
1908,6,Aniket,3,18,32,104,956,1069,845,958,111,113
1909,6,Aniket,3,19,104,97,146,343,33,230,113,197
1910,6,Aniket,3,20,97,118,180,292,-17,95,197,112
1911,6,Aniket,3,21,118,101,144,286,32,174,112,142
1912,6,Aniket,3,22,101,32,161,287,19,145,142,126
1913,6,Aniket,3,23,32,97,147,302,21,176,126,155
1914,6,Aniket,3,24,97,32,199,296,44,141,155,97
1915,6,Aniket,3,25,32,103,1016,1146,919,1049,97,130
1916,6,Aniket,3,26,103,111,243,344,113,214,130,101
1917,6,Aniket,3,27,111,111,164,275,63,174,101,111
1918,6,Aniket,3,28,111,100,231,377,120,266,111,146
1919,6,Aniket,3,29,100,32,179,308,33,162,146,129
1920,6,Aniket,3,30,32,100,457,666,328,537,129,209
1921,6,Aniket,3,31,100,20,255,395,46,186,209,140
1922,6,Aniket,3,32,20,20,989,1128,849,988,140,139
1923,6,Aniket,3,33,20,97,308,457,169,318,139,149
1924,6,Aniket,3,34,97,121,169,269,20,120,149,100
1925,6,Aniket,3,35,121,32,721,847,621,747,100,126
1926,6,Aniket,3,36,32,98,480,618,354,492,126,138
1927,6,Aniket,3,37,98,117,397,499,259,361,138,102
1928,6,Aniket,3,38,117,116,194,328,92,226,102,134
1929,6,Aniket,3,39,116,32,174,302,40,168,134,128
1930,6,Aniket,3,40,32,121,392,534,264,406,128,142
1931,6,Aniket,3,41,121,111,175,317,33,175,142,142
1932,6,Aniket,3,42,111,117,184,307,42,165,142,123
1933,6,Aniket,3,43,117,32,222,348,99,225,123,126
1934,6,Aniket,3,44,32,99,865,1114,739,988,126,249
1935,6,Aniket,3,45,99,97,219,383,-30,134,249,164
1936,6,Aniket,3,46,97,110,208,312,44,148,164,104
1937,6,Aniket,3,47,110,32,203,310,99,206,104,107
1938,6,Aniket,3,48,32,97,1668,1834,1561,1727,107,166
1939,6,Aniket,3,49,97,108,258,373,92,207,166,115
1940,6,Aniket,3,50,108,119,431,590,316,475,115,159
1941,6,Aniket,3,51,119,97,246,400,87,241,159,154
1942,6,Aniket,3,52,97,121,186,289,32,135,154,103
1943,6,Aniket,3,53,121,115,123,262,20,159,103,139
1944,6,Aniket,3,54,115,32,219,353,80,214,139,134
1945,6,Aniket,3,55,32,102,1174,1336,1040,1202,134,162
1946,6,Aniket,3,56,102,97,209,404,47,242,162,195
1947,6,Aniket,3,57,97,99,176,319,-19,124,195,143
1948,6,Aniket,3,58,99,101,159,316,16,173,143,157
1949,6,Aniket,3,59,101,32,200,328,43,171,157,128
1950,6,Aniket,3,60,32,97,236,374,108,246,128,138
1951,6,Aniket,3,61,97,32,170,296,32,158,138,126
1952,6,Aniket,3,62,32,98,640,796,514,670,126,156
1953,6,Aniket,3,63,98,97,113,264,-43,108,156,151
1954,6,Aniket,3,64,97,100,943,1088,792,937,151,145
1955,6,Aniket,3,65,100,32,165,307,20,162,145,142
1956,6,Aniket,3,66,32,100,539,738,397,596,142,199
1957,6,Aniket,3,67,100,97,219,394,20,195,199,175
1958,6,Aniket,3,68,97,121,156,256,-19,81,175,100
1959,6,Aniket,3,69,121,32,735,859,635,759,100,124
1960,6,Aniket,3,70,32,119,486,633,362,509,124,147
1961,6,Aniket,3,71,119,105,458,568,311,421,147,110
1962,6,Aniket,3,72,105,116,200,339,90,229,110,139
1963,6,Aniket,3,73,116,104,120,244,-19,105,139,124
1964,6,Aniket,3,74,104,32,266,410,142,286,124,144
1965,6,Aniket,3,75,32,97,213,359,69,215,144,146
1966,6,Aniket,3,76,97,32,267,395,121,249,146,128
1967,6,Aniket,3,77,32,103,665,774,537,646,128,109
1968,6,Aniket,3,78,103,111,221,321,112,212,109,100
1969,6,Aniket,3,79,111,111,155,260,55,160,100,105
1970,6,Aniket,3,80,111,100,210,358,105,253,105,148
1971,6,Aniket,3,81,100,32,180,271,32,123,148,91
1972,6,Aniket,3,82,32,97,231,402,140,311,91,171
1973,6,Aniket,3,83,97,116,193,287,22,116,171,94
1974,6,Aniket,3,84,116,116,416,523,322,429,94,107
1975,6,Aniket,3,85,116,105,777,891,670,784,107,114
1976,6,Aniket,3,86,105,116,391,516,277,402,114,125
1977,6,Aniket,3,87,116,117,199,317,74,192,125,118
1978,6,Aniket,3,88,117,100,425,616,307,498,118,191
1979,6,Aniket,3,89,100,101,174,390,-17,199,191,216
1980,6,Aniket,4,0,13,116,1108,1268,992,1152,116,160
1981,6,Aniket,4,1,116,104,139,244,-21,84,160,105
1982,6,Aniket,4,2,104,101,161,351,56,246,105,190
1983,6,Aniket,4,3,101,32,231,342,41,152,190,111
1984,6,Aniket,4,4,32,98,692,874,581,763,111,182
1985,6,Aniket,4,5,98,101,286,445,104,263,182,159
1986,6,Aniket,4,6,101,115,281,401,122,242,159,120
1987,6,Aniket,4,7,115,116,151,254,31,134,120,103
1988,6,Aniket,4,8,116,32,250,398,147,295,103,148
1989,6,Aniket,4,9,32,112,800,904,652,756,148,104
1990,6,Aniket,4,10,112,114,226,458,122,354,104,232
1991,6,Aniket,4,11,114,101,249,394,17,162,232,145
1992,6,Aniket,4,12,101,112,175,273,30,128,145,98
1993,6,Aniket,4,13,112,97,930,1064,832,966,98,134
1994,6,Aniket,4,14,97,114,241,399,107,265,134,158
1995,6,Aniket,4,15,114,97,179,336,21,178,158,157
1996,6,Aniket,4,16,97,116,269,417,112,260,157,148
1997,6,Aniket,4,17,116,105,181,365,33,217,148,184
1998,6,Aniket,4,18,105,111,136,286,-48,102,184,150
1999,6,Aniket,4,19,111,110,242,377,92,227,150,135
2000,6,Aniket,4,20,110,32,216,325,81,190,135,109
2001,6,Aniket,4,21,32,102,878,1021,769,912,109,143
2002,6,Aniket,4,22,102,111,188,295,45,152,143,107
2003,6,Aniket,4,23,111,114,140,288,33,181,107,148
2004,6,Aniket,4,24,114,32,181,276,33,128,148,95
2005,6,Aniket,4,25,32,116,162,287,67,192,95,125
2006,6,Aniket,4,26,116,111,223,340,98,215,125,117
2007,6,Aniket,4,27,111,109,229,343,112,226,117,114
2008,6,Aniket,4,28,109,109,179,290,65,176,114,111
2009,6,Aniket,4,29,109,111,168,297,57,186,111,129
2010,6,Aniket,4,30,111,114,276,398,147,269,129,122
2011,6,Aniket,4,31,114,114,187,283,65,161,122,96
2012,6,Aniket,4,32,114,111,143,246,47,150,96,103
2013,6,Aniket,4,33,111,119,403,532,300,429,103,129
2014,6,Aniket,4,34,119,32,737,859,608,730,129,122
2015,6,Aniket,4,35,32,8,3004,3102,2882,2980,122,98
2016,6,Aniket,4,36,8,8,174,281,76,183,98,107
2017,6,Aniket,4,37,8,8,165,266,58,159,107,101
2018,6,Aniket,4,38,8,8,156,260,55,159,101,104
2019,6,Aniket,4,39,8,8,170,272,66,168,104,102
2020,6,Aniket,4,40,8,8,178,275,76,173,102,97
2021,6,Aniket,4,41,8,8,400,491,303,394,97,91
2022,6,Aniket,4,42,8,111,534,641,443,550,91,107
2023,6,Aniket,4,43,111,114,438,535,331,428,107,97
2024,6,Aniket,4,44,114,114,170,268,73,171,97,98
2025,6,Aniket,4,45,114,111,176,286,78,188,98,110
2026,6,Aniket,4,46,111,119,420,560,310,450,110,140
2027,6,Aniket,4,47,119,32,553,677,413,537,140,124
2028,6,Aniket,4,48,32,105,682,776,558,652,124,94
2029,6,Aniket,4,49,105,115,208,337,114,243,94,129
2030,6,Aniket,4,50,115,32,238,352,109,223,129,114
2031,6,Aniket,4,51,32,100,5342,5504,5228,5390,114,162
2032,6,Aniket,4,52,100,111,200,373,38,211,162,173
2033,6,Aniket,4,53,111,105,141,264,-32,91,173,123
2034,6,Aniket,4,54,105,110,420,552,297,429,123,132
2035,6,Aniket,4,55,110,103,333,440,201,308,132,107
2036,6,Aniket,4,56,103,32,706,823,599,716,107,117
2037,6,Aniket,4,57,32,121,845,960,728,843,117,115
2038,6,Aniket,4,58,121,111,146,261,31,146,115,115
2039,6,Aniket,4,59,111,117,218,326,103,211,115,108
2040,6,Aniket,4,60,117,114,349,484,241,376,108,135
2041,6,Aniket,4,61,114,32,235,349,100,214,135,114
2042,6,Aniket,4,62,32,98,1216,1345,1102,1231,114,129
2043,6,Aniket,4,63,98,101,161,312,32,183,129,151
2044,6,Aniket,4,64,101,115,233,398,82,247,151,165
2045,6,Aniket,4,65,115,116,134,243,-31,78,165,109
2046,6,Aniket,4,66,116,32,293,415,184,306,109,122
2047,6,Aniket,4,67,32,116,627,763,505,641,122,136
2048,6,Aniket,4,68,116,111,217,333,81,197,136,116
2049,6,Aniket,4,69,111,100,352,541,236,425,116,189
2050,6,Aniket,4,70,100,97,208,388,19,199,189,180
2051,6,Aniket,4,71,97,121,216,310,36,130,180,94
2402,8,Laxmi1,0,0,97,110,184,313,-33,96,217,129
2403,8,Laxmi1,0,1,110,121,245,366,116,237,129,121
2404,8,Laxmi1,0,2,121,32,269,393,148,272,121,124
2405,8,Laxmi1,0,3,32,116,556,677,432,553,124,121
2406,8,Laxmi1,0,4,116,114,181,290,60,169,121,109
2407,8,Laxmi1,0,5,114,97,211,361,102,252,109,150
2408,8,Laxmi1,0,6,97,110,795,911,645,761,150,116
2409,8,Laxmi1,0,7,110,115,239,384,123,268,116,145
2410,8,Laxmi1,0,8,115,105,558,635,413,490,145,77
2411,8,Laxmi1,0,9,105,116,260,325,183,248,77,65
2412,8,Laxmi1,0,10,116,105,582,682,517,617,65,100
2413,8,Laxmi1,0,11,105,111,228,322,128,222,100,94
2414,8,Laxmi1,0,12,111,110,403,498,309,404,94,95
2415,8,Laxmi1,0,13,110,32,203,279,108,184,95,76
2416,8,Laxmi1,0,14,32,105,386,478,310,402,76,92
2417,8,Laxmi1,0,15,105,115,312,455,220,363,92,143
2418,8,Laxmi1,0,16,115,32,125,254,-18,111,143,129
2419,8,Laxmi1,0,17,32,101,323,453,194,324,129,130
2420,8,Laxmi1,0,18,101,97,326,468,196,338,130,142
2421,8,Laxmi1,0,19,97,115,248,397,106,255,142,149
2422,8,Laxmi1,0,20,115,105,311,401,162,252,149,90
2423,8,Laxmi1,0,21,105,101,280,429,190,339,90,149
2424,8,Laxmi1,0,22,101,114,246,342,97,193,149,96
2425,8,Laxmi1,0,23,114,32,769,977,673,881,96,208
2426,8,Laxmi1,0,24,32,105,836,946,628,738,208,110
2427,8,Laxmi1,0,25,105,102,389,518,279,408,110,129
2428,8,Laxmi1,0,26,102,32,165,229,36,100,129,64
2429,8,Laxmi1,0,27,32,121,252,338,188,274,64,86
2430,8,Laxmi1,0,28,121,111,515,636,429,550,86,121
2431,8,Laxmi1,0,29,111,117,698,775,577,654,121,77
2432,8,Laxmi1,0,30,117,32,270,373,193,296,77,103
2433,8,Laxmi1,0,31,32,98,935,1043,832,940,103,108
2434,8,Laxmi1,0,32,98,101,433,589,325,481,108,156
2435,8,Laxmi1,0,33,101,108,362,482,206,326,156,120
2436,8,Laxmi1,0,34,108,105,272,361,152,241,120,89
2437,8,Laxmi1,0,35,105,101,210,381,121,292,89,171
2438,8,Laxmi1,0,36,101,118,412,515,241,344,171,103
2439,8,Laxmi1,0,37,118,101,214,350,111,247,103,136
2440,8,Laxmi1,0,38,101,32,226,383,90,247,136,157
2441,8,Laxmi1,0,39,32,105,664,769,507,612,157,105
2442,8,Laxmi1,0,40,105,110,295,400,190,295,105,105
2443,8,Laxmi1,0,41,110,32,198,285,93,180,105,87
2444,8,Laxmi1,0,42,32,121,376,481,289,394,87,105
2445,8,Laxmi1,0,43,121,111,535,651,430,546,105,116
2446,8,Laxmi1,0,44,111,117,355,465,239,349,116,110
2447,8,Laxmi1,0,45,117,114,338,458,228,348,110,120
2448,8,Laxmi1,0,46,114,115,344,490,224,370,120,146
2449,8,Laxmi1,0,47,115,101,241,369,95,223,146,128
2450,8,Laxmi1,0,48,101,108,335,458,207,330,128,123
2451,8,Laxmi1,0,49,108,102,682,821,559,698,123,139
2452,8,Laxmi1,0,50,102,32,1162,1327,1023,1188,139,165
2453,8,Laxmi1,0,51,32,97,610,756,445,591,165,146
2454,8,Laxmi1,0,52,97,110,213,333,67,187,146,120
2455,8,Laxmi1,0,53,110,100,338,468,218,348,120,130
2456,8,Laxmi1,0,54,100,32,168,313,38,183,130,145
2457,8,Laxmi1,0,55,32,121,868,979,723,834,145,111
2458,8,Laxmi1,0,56,121,111,471,581,360,470,111,110
2459,8,Laxmi1,0,57,111,117,247,324,137,214,110,77
2460,8,Laxmi1,0,58,117,114,386,536,309,459,77,150
2461,8,Laxmi1,0,59,114,32,169,289,19,139,150,120
2462,8,Laxmi1,0,60,32,116,313,432,193,312,120,119
2463,8,Laxmi1,0,61,116,97,210,356,91,237,119,146
2464,8,Laxmi1,0,62,97,108,404,533,258,387,146,129
2465,8,Laxmi1,0,63,108,101,311,447,182,318,129,136
2466,8,Laxmi1,0,64,101,110,407,518,271,382,136,111
2467,8,Laxmi1,0,65,110,116,360,461,249,350,111,101
2468,8,Laxmi1,1,0,13,105,1295,1419,1186,1310,109,124
2469,8,Laxmi1,1,1,105,116,263,416,139,292,124,153
2470,8,Laxmi1,1,2,116,32,224,343,71,190,153,119
2471,8,Laxmi1,1,3,32,100,442,589,323,470,119,147
2472,8,Laxmi1,1,4,100,111,246,361,99,214,147,115
2473,8,Laxmi1,1,5,111,101,214,336,99,221,115,122
2474,8,Laxmi1,1,6,101,115,282,429,160,307,122,147
2475,8,Laxmi1,1,7,115,32,1070,1188,923,1041,147,118
2476,8,Laxmi1,1,8,32,110,417,502,299,384,118,85
2477,8,Laxmi1,1,9,110,111,377,465,292,380,85,88
2478,8,Laxmi1,1,10,111,116,436,583,348,495,88,147
2479,8,Laxmi1,1,11,116,32,207,310,60,163,147,103
2480,8,Laxmi1,1,12,32,109,272,370,169,267,103,98
2481,8,Laxmi1,1,13,109,97,299,441,201,343,98,142
2482,8,Laxmi1,1,14,97,116,315,406,173,264,142,91
2483,8,Laxmi1,1,15,116,116,137,234,46,143,91,97
2484,8,Laxmi1,1,16,116,101,265,360,168,263,97,95
2485,8,Laxmi1,1,17,101,114,187,300,92,205,95,113
2486,8,Laxmi1,1,18,114,32,440,588,327,475,113,148
2487,8,Laxmi1,1,19,32,104,617,704,469,556,148,87
2488,8,Laxmi1,1,20,104,111,458,558,371,471,87,100
2489,8,Laxmi1,1,21,111,119,712,845,612,745,100,133
2490,8,Laxmi1,1,22,119,32,241,380,108,247,133,139
2491,8,Laxmi1,1,23,32,115,835,988,696,849,139,153
2492,8,Laxmi1,1,24,115,108,422,537,269,384,153,115
2493,8,Laxmi1,1,25,108,111,206,310,91,195,115,104
2494,8,Laxmi1,1,26,111,119,945,1115,841,1011,104,170
2495,8,Laxmi1,1,27,119,108,289,423,119,253,170,134
2496,8,Laxmi1,1,28,108,121,499,590,365,456,134,91
2497,8,Laxmi1,1,29,121,32,630,795,539,704,91,165
2498,8,Laxmi1,1,30,32,121,658,743,493,578,165,85
2499,8,Laxmi1,1,31,121,111,400,521,315,436,85,121
2500,8,Laxmi1,1,32,111,117,276,350,155,229,121,74
2501,8,Laxmi1,1,33,117,32,261,368,187,294,74,107
2502,8,Laxmi1,1,34,32,103,549,686,442,579,107,137
2503,8,Laxmi1,1,35,103,111,168,288,31,151,137,120
2504,8,Laxmi1,1,36,111,32,280,434,160,314,120,154
2505,8,Laxmi1,1,37,32,97,699,832,545,678,154,133
2506,8,Laxmi1,1,38,97,115,242,372,109,239,133,130
2507,8,Laxmi1,1,39,115,32,164,249,34,119,130,85
2508,8,Laxmi1,1,40,32,108,413,509,328,424,85,96
2509,8,Laxmi1,1,41,108,111,170,282,74,186,96,112
2510,8,Laxmi1,1,42,111,110,363,466,251,354,112,103
2511,8,Laxmi1,1,43,110,103,337,440,234,337,103,103
2512,8,Laxmi1,1,44,103,32,260,379,157,276,103,119
2513,8,Laxmi1,1,45,32,97,795,928,676,809,119,133
2514,8,Laxmi1,1,46,97,115,241,374,108,241,133,133
2515,8,Laxmi1,1,47,115,32,170,275,37,142,133,105
2516,8,Laxmi1,1,48,32,121,440,518,335,413,105,78
2517,8,Laxmi1,1,49,121,111,593,694,515,616,78,101
2518,8,Laxmi1,1,50,111,117,849,970,748,869,101,121
2519,8,Laxmi1,1,51,117,32,783,931,662,810,121,148
2520,8,Laxmi1,1,52,32,100,1402,1537,1254,1389,148,135
2521,8,Laxmi1,1,53,100,111,230,342,95,207,135,112
2522,8,Laxmi1,1,54,111,110,1114,1203,1002,1091,112,89
2523,8,Laxmi1,1,55,110,111,426,528,337,439,89,102
2524,8,Laxmi1,1,56,111,116,384,481,282,379,102,97
2525,8,Laxmi1,1,57,116,32,295,391,198,294,97,96
2526,8,Laxmi1,1,58,32,115,949,1085,853,989,96,136
2527,8,Laxmi1,1,59,115,116,235,327,99,191,136,92
2528,8,Laxmi1,1,60,116,111,484,579,392,487,92,95
2529,8,Laxmi1,1,61,111,112,213,317,118,222,95,104
2530,8,Laxmi1,1,62,112,37,1593,1743,1489,1639,104,150
2531,8,Laxmi1,1,63,37,37,220,320,70,170,150,100
2532,8,Laxmi1,1,64,37,37,173,253,73,153,100,80
2533,8,Laxmi1,1,65,37,37,153,252,73,172,80,99
2534,8,Laxmi1,1,66,37,37,185,275,86,176,99,90
2535,8,Laxmi1,1,67,37,37,166,263,76,173,90,97
2536,8,Laxmi1,1,68,37,37,196,267,99,170,97,71
2537,8,Laxmi1,1,69,37,37,388,501,317,430,71,113
2538,8,Laxmi1,1,70,37,32,899,996,786,883,113,97
2539,8,Laxmi1,1,71,32,39,488,1204,391,1107,97,716
2540,8,Laxmi1,1,72,39,39,497,716,-219,0,716,219
2541,8,Laxmi1,1,73,39,39,31,219,-188,0,219,188
2542,8,Laxmi1,1,74,39,39,31,188,-157,0,188,157
2543,8,Laxmi1,1,75,39,39,31,157,-126,0,157,126
2544,8,Laxmi1,1,76,39,39,30,126,-96,0,126,96
2545,8,Laxmi1,1,77,39,39,29,96,-67,0,96,67
2546,8,Laxmi1,1,78,39,39,31,67,-36,0,67,36
2547,8,Laxmi1,1,79,39,39,28,36,-8,0,36,8
2548,8,Laxmi1,2,0,13,119,2112,2265,2007,2160,105,153
2549,8,Laxmi1,2,1,119,101,224,354,71,201,153,130
2550,8,Laxmi1,2,2,101,32,183,290,53,160,130,107
2551,8,Laxmi1,2,3,32,107,537,647,430,540,107,110
2552,8,Laxmi1,2,4,107,110,536,620,426,510,110,84
2553,8,Laxmi1,2,5,110,111,447,534,363,450,84,87
2554,8,Laxmi1,2,6,111,119,552,692,465,605,87,140
2555,8,Laxmi1,2,7,119,32,252,378,112,238,140,126
2556,8,Laxmi1,2,8,32,119,1459,1606,1333,1480,126,147
2557,8,Laxmi1,2,9,119,104,381,518,234,371,147,137
2558,8,Laxmi1,2,10,104,97,562,705,425,568,137,143
2559,8,Laxmi1,2,11,97,116,183,297,40,154,143,114
2560,8,Laxmi1,2,12,116,32,310,419,196,305,114,109
2561,8,Laxmi1,2,13,32,119,946,1069,837,960,109,123
2562,8,Laxmi1,2,14,119,101,204,333,81,210,123,129
2563,8,Laxmi1,2,15,101,32,963,1132,834,1003,129,169
2564,8,Laxmi1,2,16,32,97,1602,1751,1433,1582,169,149
2565,8,Laxmi1,2,17,97,114,266,375,117,226,149,109
2566,8,Laxmi1,2,18,114,101,220,360,111,251,109,140
2567,8,Laxmi1,2,19,101,32,202,290,62,150,140,88
2568,8,Laxmi1,2,20,32,98,438,536,350,448,88,98
2569,8,Laxmi1,2,21,98,117,457,561,359,463,98,104
2570,8,Laxmi1,2,22,117,116,305,403,201,299,104,98
2571,8,Laxmi1,2,23,116,32,1060,1171,962,1073,98,111
2572,8,Laxmi1,2,24,32,107,1202,1318,1091,1207,111,116
2573,8,Laxmi1,2,25,107,110,269,351,153,235,116,82
2574,8,Laxmi1,2,26,110,111,396,508,314,426,82,112
2575,8,Laxmi1,2,27,111,119,402,550,290,438,112,148
2576,8,Laxmi1,2,28,119,32,305,432,157,284,148,127
2577,8,Laxmi1,2,29,32,110,796,887,669,760,127,91
2578,8,Laxmi1,2,30,110,111,344,439,253,348,91,95
2579,8,Laxmi1,2,31,111,116,386,477,291,382,95,91
2580,8,Laxmi1,2,32,116,32,336,453,245,362,91,117
2581,8,Laxmi1,2,33,32,119,854,988,737,871,117,134
2582,8,Laxmi1,2,34,119,104,247,358,113,224,134,111
2583,8,Laxmi1,2,35,104,97,352,525,241,414,111,173
2584,8,Laxmi1,2,36,97,116,214,316,41,143,173,102
2585,8,Laxmi1,2,37,116,32,274,384,172,282,102,110
2586,8,Laxmi1,2,38,32,119,165,303,55,193,110,138
2587,8,Laxmi1,2,39,119,101,233,371,95,233,138,138
2588,8,Laxmi1,2,40,101,32,176,278,38,140,138,102
2589,8,Laxmi1,2,41,32,109,823,922,721,820,102,99
2590,8,Laxmi1,2,42,109,97,228,376,129,277,99,148
2591,8,Laxmi1,2,43,97,121,400,514,252,366,148,114
2592,8,Laxmi1,2,44,121,32,394,529,280,415,114,135
2593,8,Laxmi1,2,45,32,98,578,686,443,551,135,108
2594,8,Laxmi1,2,46,98,101,259,369,151,261,108,110
2595,8,Laxmi1,3,0,13,121,1162,1251,1046,1135,116,89
2596,8,Laxmi1,3,1,121,111,436,513,347,424,89,77
2597,8,Laxmi1,3,2,111,117,232,311,155,234,77,79
2598,8,Laxmi1,3,3,117,32,262,379,183,300,79,117
2599,8,Laxmi1,3,4,32,99,402,498,285,381,117,96
2600,8,Laxmi1,3,5,99,97,256,394,160,298,96,138
2601,8,Laxmi1,3,6,97,110,269,402,131,264,138,133
2602,8,Laxmi1,3,7,110,116,360,468,227,335,133,108
2603,8,Laxmi1,3,8,116,32,866,1008,758,900,108,142
2604,8,Laxmi1,3,9,32,97,452,610,310,468,142,158
2605,8,Laxmi1,3,10,97,108,247,373,89,215,158,126
2606,8,Laxmi1,3,11,108,119,1057,1150,931,1024,126,93
2607,8,Laxmi1,3,12,119,97,244,389,151,296,93,145
2608,8,Laxmi1,3,13,97,121,351,458,206,313,145,107
2609,8,Laxmi1,3,14,121,115,213,355,106,248,107,142
2610,8,Laxmi1,3,15,115,32,423,586,281,444,142,163
2611,8,Laxmi1,3,16,32,104,880,939,717,776,163,59
2612,8,Laxmi1,3,17,104,97,540,700,481,641,59,160
2613,8,Laxmi1,3,18,97,118,561,661,401,501,160,100
2614,8,Laxmi1,3,19,118,101,300,439,200,339,100,139
2615,8,Laxmi1,3,20,101,32,158,283,19,144,139,125
2616,8,Laxmi1,3,21,32,97,221,354,96,229,125,133
2617,8,Laxmi1,3,22,97,32,177,308,44,175,133,131
2618,8,Laxmi1,3,23,32,103,296,386,165,255,131,90
2619,8,Laxmi1,3,24,103,111,491,591,401,501,90,100
2620,8,Laxmi1,3,25,111,111,137,241,37,141,100,104
2621,8,Laxmi1,3,26,111,100,220,371,116,267,104,151
2622,8,Laxmi1,3,27,100,32,189,311,38,160,151,122
2623,8,Laxmi1,3,28,32,100,1286,1372,1164,1250,122,86
2624,8,Laxmi1,3,29,100,97,224,387,138,301,86,163
2625,8,Laxmi1,3,30,97,121,321,419,158,256,163,98
2626,8,Laxmi1,3,31,121,32,285,386,187,288,98,101
2627,8,Laxmi1,3,32,32,98,577,666,476,565,101,89
2628,8,Laxmi1,3,33,98,117,577,680,488,591,89,103
2629,8,Laxmi1,3,34,117,116,264,356,161,253,103,92
2630,8,Laxmi1,3,35,116,32,662,786,570,694,92,124
2631,8,Laxmi1,3,36,32,121,683,742,559,618,124,59
2632,8,Laxmi1,3,37,121,111,526,630,467,571,59,104
2633,8,Laxmi1,3,38,111,117,246,331,142,227,104,85
2634,8,Laxmi1,3,39,117,32,1598,1709,1513,1624,85,111
2635,8,Laxmi1,3,40,32,99,189,268,78,157,111,79
2636,8,Laxmi1,3,41,99,97,604,769,525,690,79,165
2637,8,Laxmi1,3,42,97,110,317,431,152,266,165,114
2638,8,Laxmi1,3,43,110,32,231,331,117,217,114,100
2639,8,Laxmi1,3,44,32,97,1984,2182,1884,2082,100,198
2640,8,Laxmi1,3,45,97,108,282,406,84,208,198,124
2641,8,Laxmi1,3,46,108,119,454,610,330,486,124,156
2642,8,Laxmi1,3,47,119,97,431,600,275,444,156,169
2643,8,Laxmi1,3,48,97,121,305,414,136,245,169,109
2644,8,Laxmi1,3,49,121,115,281,440,172,331,109,159
2645,8,Laxmi1,3,50,115,32,884,994,725,835,159,110
2646,8,Laxmi1,3,51,32,102,549,654,439,544,110,105
2647,8,Laxmi1,3,52,102,97,274,432,169,327,105,158
2648,8,Laxmi1,3,53,97,99,245,353,87,195,158,108
2649,8,Laxmi1,3,54,99,101,232,384,124,276,108,152
2650,8,Laxmi1,3,55,101,32,186,317,34,165,152,131
2651,8,Laxmi1,3,56,32,97,204,380,73,249,131,176
2652,8,Laxmi1,3,57,97,32,208,303,32,127,176,95
2653,8,Laxmi1,3,58,32,98,444,543,349,448,95,99
2654,8,Laxmi1,3,59,98,97,233,395,134,296,99,162
2655,8,Laxmi1,3,60,97,100,251,359,89,197,162,108
2656,8,Laxmi1,3,61,100,32,649,797,541,689,108,148
2657,8,Laxmi1,3,62,32,100,645,768,497,620,148,123
2658,8,Laxmi1,3,63,100,97,263,415,140,292,123,152
2659,8,Laxmi1,3,64,97,121,288,409,136,257,152,121
2660,8,Laxmi1,3,65,121,32,320,441,199,320,121,121
2661,8,Laxmi1,3,66,32,119,1212,1385,1091,1264,121,173
2662,8,Laxmi1,3,67,119,105,385,509,212,336,173,124
2663,8,Laxmi1,3,68,105,116,360,462,236,338,124,102
2664,8,Laxmi1,3,69,116,104,247,364,145,262,102,117
2665,8,Laxmi1,3,70,104,32,387,502,270,385,117,115
2666,8,Laxmi1,3,71,32,97,1197,1369,1082,1254,115,172
2667,8,Laxmi1,3,72,97,32,204,289,32,117,172,85
2668,8,Laxmi1,3,73,32,103,280,377,195,292,85,97
2669,8,Laxmi1,3,74,103,111,488,562,391,465,97,74
2670,8,Laxmi1,3,75,111,111,140,234,66,160,74,94
2671,8,Laxmi1,3,76,111,100,316,483,222,389,94,167
2672,8,Laxmi1,3,77,100,32,223,328,56,161,167,105
2673,8,Laxmi1,3,78,32,97,707,862,602,757,105,155
2674,8,Laxmi1,3,79,97,116,272,364,117,209,155,92
2675,8,Laxmi1,3,80,116,116,162,269,70,177,92,107
2676,8,Laxmi1,3,81,116,105,441,561,334,454,107,120
2677,8,Laxmi1,3,82,105,116,351,448,231,328,120,97
2678,8,Laxmi1,3,83,116,117,318,423,221,326,97,105
2679,8,Laxmi1,3,84,117,100,430,522,325,417,105,92
2680,8,Laxmi1,3,85,100,101,238,407,146,315,92,169
2681,8,Laxmi1,4,0,13,116,750,846,650,746,100,96
2682,8,Laxmi1,4,1,116,104,219,324,123,228,96,105
2683,8,Laxmi1,4,2,104,101,206,331,101,226,105,125
2684,8,Laxmi1,4,3,101,32,165,295,40,170,125,130
2685,8,Laxmi1,4,4,32,98,331,430,201,300,130,99
2686,8,Laxmi1,4,5,98,101,374,494,275,395,99,120
2687,8,Laxmi1,4,6,101,115,341,517,221,397,120,176
2688,8,Laxmi1,4,7,115,116,195,310,19,134,176,115
2689,8,Laxmi1,4,8,116,32,317,427,202,312,115,110
2690,8,Laxmi1,4,9,32,112,1300,1393,1190,1283,110,93
2691,8,Laxmi1,4,10,112,114,569,696,476,603,93,127
2692,8,Laxmi1,4,11,114,101,214,361,87,234,127,147
2693,8,Laxmi1,4,12,101,112,517,615,370,468,147,98
2694,8,Laxmi1,4,13,112,97,261,434,163,336,98,173
2695,8,Laxmi1,4,14,97,114,280,382,107,209,173,102
2696,8,Laxmi1,4,15,114,97,191,367,89,265,102,176
2697,8,Laxmi1,4,16,97,116,196,292,20,116,176,96
2698,8,Laxmi1,4,17,116,105,483,593,387,497,96,110
2699,8,Laxmi1,4,18,105,111,209,312,99,202,110,103
2700,8,Laxmi1,4,19,111,110,249,356,146,253,103,107
2701,8,Laxmi1,4,20,110,32,234,328,127,221,107,94
2702,8,Laxmi1,4,21,32,102,1702,1843,1608,1749,94,141
2703,8,Laxmi1,4,22,102,111,251,354,110,213,141,103
2704,8,Laxmi1,4,23,111,114,229,349,126,246,103,120
2705,8,Laxmi1,4,24,114,32,202,322,82,202,120,120
2706,8,Laxmi1,4,25,32,116,352,444,232,324,120,92
2707,8,Laxmi1,4,26,116,111,500,597,408,505,92,97
2708,8,Laxmi1,4,27,111,109,242,366,145,269,97,124
2709,8,Laxmi1,4,28,109,111,514,612,390,488,124,98
2710,8,Laxmi1,4,29,111,114,437,507,339,409,98,70
2711,8,Laxmi1,4,30,114,114,1071,1167,1001,1097,70,96
2712,8,Laxmi1,4,31,114,111,2581,2681,2485,2585,96,100
2713,8,Laxmi1,4,32,111,119,521,661,421,561,100,140
2714,8,Laxmi1,4,33,119,32,207,323,67,183,140,116
2715,8,Laxmi1,4,34,32,105,707,809,591,693,116,102
2716,8,Laxmi1,4,35,105,115,306,438,204,336,102,132
2717,8,Laxmi1,4,36,115,32,166,265,34,133,132,99
2718,8,Laxmi1,4,37,32,100,329,468,230,369,99,139
2719,8,Laxmi1,4,38,100,111,184,285,45,146,139,101
2720,8,Laxmi1,4,39,111,105,174,266,73,165,101,92
2721,8,Laxmi1,4,40,105,110,1696,1834,1604,1742,92,138
2722,8,Laxmi1,4,41,110,103,464,576,326,438,138,112
2723,8,Laxmi1,4,42,103,32,330,446,218,334,112,116
2724,8,Laxmi1,4,43,32,121,827,935,711,819,116,108
2725,8,Laxmi1,4,44,121,111,529,641,421,533,108,112
2726,8,Laxmi1,4,45,111,117,283,369,171,257,112,86
2727,8,Laxmi1,4,46,117,114,306,446,220,360,86,140
2728,8,Laxmi1,4,47,114,32,184,298,44,158,140,114
2729,8,Laxmi1,4,48,32,98,385,508,271,394,114,123
2730,8,Laxmi1,4,49,98,101,294,408,171,285,123,114
2731,8,Laxmi1,4,50,101,115,292,446,178,332,114,154
2732,8,Laxmi1,4,51,115,116,186,279,32,125,154,93
2733,8,Laxmi1,4,52,116,32,248,360,155,267,93,112
2734,8,Laxmi1,4,53,32,116,299,368,187,256,112,69
2735,8,Laxmi1,4,54,116,111,595,735,526,666,69,140
2736,8,Laxmi1,4,55,111,100,476,570,336,430,140,94
2737,8,Laxmi1,4,56,100,97,203,375,109,281,94,172
2738,8,Laxmi1,4,57,97,121,331,431,159,259,172,100
