id,user_id,user_name,sentence_index,char_index,char_1,char_2,DD,DU,UD,UU,H1,H2
1365,5,Pavan,0,0,8,97,901,1036,817,952,84,135
1366,5,Pavan,0,1,97,110,1698,1832,1563,1697,135,134
1367,5,Pavan,0,2,110,121,101,251,-33,117,134,150
1368,5,Pavan,0,3,121,32,165,304,15,154,150,139
1369,5,Pavan,0,4,32,116,422,569,283,430,139,147
1370,5,Pavan,0,5,116,114,89,248,-58,101,147,159
1371,5,Pavan,0,6,114,110,379,503,220,344,159,124
1372,5,Pavan,0,7,110,97,188,339,64,215,124,151
1373,5,Pavan,0,8,97,115,216,408,65,257,151,192
1374,5,Pavan,0,9,115,105,176,345,-16,153,192,169
1375,5,Pavan,0,10,105,105,359,513,190,344,169,154
1376,5,Pavan,0,11,105,8,1440,1543,1286,1389,154,103
1377,5,Pavan,0,12,8,116,143,288,40,185,103,145
1378,5,Pavan,0,13,116,105,306,480,161,335,145,174
1379,5,Pavan,0,14,105,111,106,322,-68,148,174,216
1380,5,Pavan,0,15,111,110,186,296,-30,80,216,110
1381,5,Pavan,0,16,110,32,232,329,122,219,110,97
1382,5,Pavan,0,17,32,105,732,866,635,769,97,134
1383,5,Pavan,0,18,105,115,164,309,30,175,134,145
1384,5,Pavan,0,19,115,97,5422,5603,5277,5458,145,181
1385,5,Pavan,0,20,97,32,2038,2166,1857,1985,181,128
1386,5,Pavan,0,21,32,101,483,654,355,526,128,171
1387,5,Pavan,0,22,101,97,113,339,-58,168,171,226
1388,5,Pavan,0,23,97,115,335,512,109,286,226,177
1389,5,Pavan,0,24,115,105,128,336,-49,159,177,208
1390,5,Pavan,0,25,105,101,283,530,75,322,208,247
1391,5,Pavan,0,26,101,114,135,348,-112,101,247,213
1392,5,Pavan,0,27,114,8,3845,3961,3632,3748,213,116
1393,5,Pavan,0,28,8,32,2100,2196,1984,2080,116,96
1394,5,Pavan,0,29,32,105,539,663,443,567,96,124
1395,5,Pavan,0,30,105,102,104,244,-20,120,124,140
1396,5,Pavan,0,31,102,32,840,929,700,789,140,89
1397,5,Pavan,0,32,32,121,757,905,668,816,89,148
1398,5,Pavan,0,33,121,111,244,420,96,272,148,176
1399,5,Pavan,0,34,111,117,120,287,-56,111,176,167
1400,5,Pavan,0,35,117,32,434,549,267,382,167,115
1401,5,Pavan,0,36,32,98,464,579,349,464,115,115
1402,5,Pavan,0,37,98,101,204,347,89,232,115,143
1403,5,Pavan,0,38,101,108,402,573,259,430,143,171
1404,5,Pavan,0,39,108,105,113,293,-58,122,171,180
1405,5,Pavan,0,40,105,101,218,369,38,189,180,151
1406,5,Pavan,0,41,101,118,294,453,143,302,151,159
1407,5,Pavan,0,42,118,101,111,371,-48,212,159,260
1408,5,Pavan,0,43,101,32,277,424,17,164,260,147
1409,5,Pavan,0,44,32,105,830,1005,683,858,147,175
1410,5,Pavan,0,45,105,110,125,240,-50,65,175,115
1411,5,Pavan,0,46,110,32,179,332,64,217,115,153
1412,5,Pavan,0,47,32,121,370,519,217,366,153,149
1413,5,Pavan,0,48,121,111,396,595,247,446,149,199
1414,5,Pavan,0,49,111,117,131,293,-68,94,199,162
1415,5,Pavan,0,50,117,114,257,377,95,215,162,120
1416,5,Pavan,0,51,114,115,372,575,252,455,120,203
1417,5,Pavan,0,52,115,101,152,304,-51,101,203,152
1418,5,Pavan,0,53,101,108,209,344,57,192,152,135
1419,5,Pavan,0,54,108,103,244,374,109,239,135,130
1420,5,Pavan,0,55,103,8,701,833,571,703,130,132
1421,5,Pavan,0,56,8,102,117,275,-15,143,132,158
1422,5,Pavan,0,57,102,32,293,433,135,275,158,140
1423,5,Pavan,0,58,32,97,608,792,468,652,140,184
1424,5,Pavan,0,59,97,110,166,317,-18,133,184,151
1425,5,Pavan,0,60,110,100,169,308,18,157,151,139
1426,5,Pavan,0,61,100,32,155,320,16,181,139,165
1427,5,Pavan,0,62,32,121,457,590,292,425,165,133
1428,5,Pavan,0,63,121,111,165,457,32,324,133,292
1429,5,Pavan,0,64,111,117,327,480,35,188,292,153
1430,5,Pavan,0,65,117,114,186,321,33,168,153,135
1431,5,Pavan,0,66,114,32,501,627,366,492,135,126
1432,5,Pavan,0,67,32,116,405,547,279,421,126,142
1433,5,Pavan,0,68,116,97,580,729,438,587,142,149
1434,5,Pavan,0,69,97,108,192,366,43,217,149,174
1435,5,Pavan,0,70,108,101,210,374,36,200,174,164
1436,5,Pavan,0,71,101,110,207,354,43,190,164,147
1437,5,Pavan,0,72,110,116,180,323,33,176,147,143
1438,5,Pavan,1,0,13,105,1940,2065,1844,1969,96,125
1439,5,Pavan,1,1,105,116,105,224,-20,99,125,119
1440,5,Pavan,1,2,116,32,159,293,40,174,119,134
1441,5,Pavan,1,3,32,100,839,958,705,824,134,119
1442,5,Pavan,1,4,100,111,398,511,279,392,119,113
1443,5,Pavan,1,5,111,101,364,517,251,404,113,153
1444,5,Pavan,1,6,101,115,185,390,32,237,153,205
1445,5,Pavan,1,7,115,32,1905,2064,1700,1859,205,159
1446,5,Pavan,1,8,32,110,2474,2627,2315,2468,159,153
1447,5,Pavan,1,9,110,111,68,270,-85,117,153,202
1448,5,Pavan,1,10,111,116,162,304,-40,102,202,142
1449,5,Pavan,1,11,116,32,574,760,432,618,142,186
1450,5,Pavan,1,12,32,109,998,1110,812,924,186,112
1451,5,Pavan,1,13,109,97,258,395,146,283,112,137
1452,5,Pavan,1,14,97,116,488,619,351,482,137,131
1453,5,Pavan,1,15,116,116,161,250,30,119,131,89
1454,5,Pavan,1,16,116,101,216,403,127,314,89,187
1455,5,Pavan,1,17,101,114,99,270,-88,83,187,171
1456,5,Pavan,1,18,114,32,394,509,223,338,171,115
1457,5,Pavan,1,19,32,104,937,1072,822,957,115,135
1458,5,Pavan,1,20,104,111,72,209,-63,74,135,137
1459,5,Pavan,1,21,111,119,379,524,242,387,137,145
1460,5,Pavan,1,22,119,32,1326,1446,1181,1301,145,120
1461,5,Pavan,1,23,32,115,914,1048,794,928,120,134
1462,5,Pavan,1,24,115,108,256,347,122,213,134,91
1463,5,Pavan,1,25,108,111,182,282,91,191,91,100
1464,5,Pavan,1,26,111,119,205,318,105,218,100,113
1465,5,Pavan,1,27,119,108,241,358,128,245,113,117
1466,5,Pavan,1,28,108,121,628,767,511,650,117,139
1467,5,Pavan,1,29,121,32,313,433,174,294,139,120
1468,5,Pavan,1,30,32,121,965,1105,845,985,120,140
1469,5,Pavan,1,31,121,111,107,256,-33,116,140,149
1470,5,Pavan,1,32,111,117,178,315,29,166,149,137
1471,5,Pavan,1,33,117,32,176,316,39,179,137,140
1472,5,Pavan,1,34,32,103,372,517,232,377,140,145
1473,5,Pavan,1,35,103,111,228,386,83,241,145,158
1474,5,Pavan,1,36,111,32,178,306,20,148,158,128
1475,5,Pavan,1,37,32,97,183,423,55,295,128,240
1476,5,Pavan,1,38,97,115,172,336,-68,96,240,164
1477,5,Pavan,1,39,115,32,235,363,71,199,164,128
1478,5,Pavan,1,40,32,108,2634,2842,2506,2714,128,208
1479,5,Pavan,1,41,108,111,187,331,-21,123,208,144
1480,5,Pavan,1,42,111,109,179,301,35,157,144,122
1481,5,Pavan,1,43,109,8,813,914,691,792,122,101
1482,5,Pavan,1,44,8,110,367,500,266,399,101,133
1483,5,Pavan,1,45,110,103,187,337,54,204,133,150
1484,5,Pavan,1,46,103,32,130,282,-20,132,150,152
1485,5,Pavan,1,47,32,97,438,606,286,454,152,168
1486,5,Pavan,1,48,97,115,81,288,-87,120,168,207
1487,5,Pavan,1,49,115,32,335,483,128,276,207,148
1488,5,Pavan,1,50,32,121,1136,1291,988,1143,148,155
1489,5,Pavan,1,51,121,111,118,297,-37,142,155,179
1490,5,Pavan,1,52,111,117,200,355,21,176,179,155
1491,5,Pavan,1,53,117,32,268,391,113,236,155,123
1492,5,Pavan,1,54,32,100,697,828,574,705,123,131
1493,5,Pavan,1,55,100,111,735,873,604,742,131,138
1494,5,Pavan,1,56,111,32,238,344,100,206,138,106
1495,5,Pavan,1,57,32,110,208,389,102,283,106,181
1496,5,Pavan,1,58,110,111,129,302,-52,121,181,173
1497,5,Pavan,1,59,111,116,189,328,16,155,173,139
1498,5,Pavan,1,60,116,32,119,261,-20,122,139,142
1499,5,Pavan,1,61,32,115,349,489,207,347,142,140
1500,5,Pavan,1,62,115,116,304,456,164,316,140,152
1501,5,Pavan,1,63,116,111,376,609,224,457,152,233
1502,5,Pavan,1,64,111,112,47,322,-186,89,233,275
1503,5,Pavan,2,0,13,119,964,1117,856,1009,108,153
1504,5,Pavan,2,1,119,101,79,255,-74,102,153,176
1505,5,Pavan,2,2,101,32,190,320,14,144,176,130
1506,5,Pavan,2,3,32,107,814,1031,684,901,130,217
1507,5,Pavan,2,4,107,110,112,260,-105,43,217,148
1508,5,Pavan,2,5,110,111,441,601,293,453,148,160
1509,5,Pavan,2,6,111,101,193,301,33,141,160,108
1510,5,Pavan,2,7,101,8,661,825,553,717,108,164
1511,5,Pavan,2,8,8,119,127,268,-37,104,164,141
1512,5,Pavan,2,9,119,32,242,366,101,225,141,124
1513,5,Pavan,2,10,32,119,760,881,636,757,124,121
1514,5,Pavan,2,11,119,104,245,355,124,234,121,110
1515,5,Pavan,2,12,104,97,141,298,31,188,110,157
1516,5,Pavan,2,13,97,116,272,423,115,266,157,151
1517,5,Pavan,2,14,116,32,244,364,93,213,151,120
1518,5,Pavan,2,15,32,119,1475,1619,1355,1499,120,144
1519,5,Pavan,2,16,119,101,81,260,-63,116,144,179
1520,5,Pavan,2,17,101,32,213,362,34,183,179,149
1521,5,Pavan,2,18,32,97,504,675,355,526,149,171
1522,5,Pavan,2,19,97,114,433,691,262,520,171,258
1523,5,Pavan,2,20,114,101,203,358,-55,100,258,155
1524,5,Pavan,2,21,101,32,117,311,-38,156,155,194
1525,5,Pavan,2,22,32,98,819,984,625,790,194,165
1526,5,Pavan,2,23,98,117,72,265,-93,100,165,193
1527,5,Pavan,2,24,117,116,162,333,-31,140,193,171
1528,5,Pavan,2,25,116,32,361,508,190,337,171,147
1529,5,Pavan,2,26,32,107,1173,1366,1026,1219,147,193
1530,5,Pavan,2,27,107,110,68,271,-125,78,193,203
1531,5,Pavan,2,28,110,111,311,474,108,271,203,163
1532,5,Pavan,2,29,111,119,294,439,131,276,163,145
1533,5,Pavan,2,30,119,32,262,391,117,246,145,129
1534,5,Pavan,2,31,32,110,962,1144,833,1015,129,182
1535,5,Pavan,2,32,110,111,114,286,-68,104,182,172
1536,5,Pavan,2,33,111,116,289,431,117,259,172,142
1537,5,Pavan,2,34,116,32,415,519,273,377,142,104
1538,5,Pavan,2,35,32,119,1157,1298,1053,1194,104,141
1539,5,Pavan,2,36,119,104,241,395,100,254,141,154
1540,5,Pavan,2,37,104,97,132,287,-22,133,154,155
1541,5,Pavan,2,38,97,116,347,504,192,349,155,157
1542,5,Pavan,2,39,116,32,238,335,81,178,157,97
1543,5,Pavan,2,40,32,119,527,684,430,587,97,157
1544,5,Pavan,2,41,119,101,108,290,-49,133,157,182
1545,5,Pavan,2,42,101,32,135,297,-47,115,182,162
1546,5,Pavan,2,43,32,109,260,390,98,228,162,130
1547,5,Pavan,2,44,109,97,164,302,34,172,130,138
1548,5,Pavan,2,45,97,121,393,495,255,357,138,102
1549,5,Pavan,2,46,121,32,196,362,94,260,102,166
1550,5,Pavan,2,47,32,98,349,484,183,318,166,135
1551,5,Pavan,2,48,98,101,198,327,63,192,135,129
1552,5,Pavan,3,0,13,121,1497,1644,1300,1447,197,147
1553,5,Pavan,3,1,121,111,167,349,20,202,147,182
1554,5,Pavan,3,2,111,117,198,331,16,149,182,133
1555,5,Pavan,3,3,117,32,164,301,31,168,133,137
1556,5,Pavan,3,4,32,99,585,771,448,634,137,186
1557,5,Pavan,3,5,99,97,94,258,-92,72,186,164
1558,5,Pavan,3,6,97,110,206,344,42,180,164,138
1559,5,Pavan,3,7,110,116,1291,1407,1153,1269,138,116
1560,5,Pavan,3,8,116,32,304,418,188,302,116,114
1561,5,Pavan,3,9,32,97,368,502,254,388,114,134
1562,5,Pavan,3,10,97,108,589,695,455,561,134,106
1563,5,Pavan,3,11,108,119,238,470,132,364,106,232
1564,5,Pavan,3,12,119,97,184,355,-48,123,232,171
1565,5,Pavan,3,13,97,121,1630,1800,1459,1629,171,170
1566,5,Pavan,3,14,121,115,201,322,31,152,170,121
1567,5,Pavan,3,15,115,32,182,335,61,214,121,153
1568,5,Pavan,3,16,32,104,866,1003,713,850,153,137
1569,5,Pavan,3,17,104,97,104,286,-33,149,137,182
1570,5,Pavan,3,18,97,118,221,362,39,180,182,141
1571,5,Pavan,3,19,118,101,380,534,239,393,141,154
1572,5,Pavan,3,20,101,32,246,391,92,237,154,145
1573,5,Pavan,3,21,32,97,184,352,39,207,145,168
1574,5,Pavan,3,22,97,32,186,297,18,129,168,111
1575,5,Pavan,3,23,32,103,555,717,444,606,111,162
1576,5,Pavan,3,24,103,111,275,374,113,212,162,99
1577,5,Pavan,3,25,111,111,130,239,31,140,99,109
1578,5,Pavan,3,26,111,100,155,302,46,193,109,147
1579,5,Pavan,3,27,100,32,212,356,65,209,147,144
1580,5,Pavan,3,28,32,100,261,456,117,312,144,195
1581,5,Pavan,3,29,100,97,146,335,-49,140,195,189
1582,5,Pavan,3,30,97,121,401,582,212,393,189,181
1583,5,Pavan,3,31,121,32,197,337,16,156,181,140
1584,5,Pavan,3,32,32,98,1593,1708,1453,1568,140,115
1585,5,Pavan,3,33,98,117,48,247,-67,132,115,199
1586,5,Pavan,3,34,117,116,237,399,38,200,199,162
1587,5,Pavan,3,35,116,32,192,329,30,167,162,137
1588,5,Pavan,3,36,32,121,896,1047,759,910,137,151
1589,5,Pavan,3,37,121,111,170,361,19,210,151,191
1590,5,Pavan,3,38,111,117,120,251,-71,60,191,131
1591,5,Pavan,3,39,117,32,316,445,185,314,131,129
1592,5,Pavan,3,40,32,99,389,580,260,451,129,191
1593,5,Pavan,3,41,99,97,212,403,21,212,191,191
1594,5,Pavan,3,42,97,110,209,328,18,137,191,119
1595,5,Pavan,3,43,110,32,523,643,404,524,119,120
1596,5,Pavan,3,44,32,97,570,725,450,605,120,155
1597,5,Pavan,3,45,97,108,222,416,67,261,155,194
1598,5,Pavan,3,46,108,119,334,510,140,316,194,176
1599,5,Pavan,3,47,119,97,127,324,-49,148,176,197
1600,5,Pavan,3,48,97,121,517,639,320,442,197,122
1601,5,Pavan,3,49,121,115,459,610,337,488,122,151
1602,5,Pavan,3,50,115,32,185,352,34,201,151,167
1603,5,Pavan,3,51,32,102,861,1006,694,839,167,145
1604,5,Pavan,3,52,102,97,166,324,21,179,145,158
1605,5,Pavan,3,53,97,99,109,252,-49,94,158,143
1606,5,Pavan,3,54,99,101,228,386,85,243,143,158
1607,5,Pavan,3,55,101,32,191,326,33,168,158,135
1608,5,Pavan,3,56,32,97,167,346,32,211,135,179
1609,5,Pavan,3,57,97,32,281,374,102,195,179,93
1610,5,Pavan,3,58,32,98,300,425,207,332,93,125
1611,5,Pavan,3,59,98,97,230,468,105,343,125,238
1612,5,Pavan,3,60,97,100,608,748,370,510,238,140
1613,5,Pavan,3,61,100,32,353,516,213,376,140,163
1614,5,Pavan,3,62,32,100,635,829,472,666,163,194
1615,5,Pavan,3,63,100,97,130,317,-64,123,194,187
1616,5,Pavan,3,64,97,121,203,370,16,183,187,167
1617,5,Pavan,3,65,121,32,239,372,72,205,167,133
1618,5,Pavan,3,66,32,119,845,980,712,847,133,135
1619,5,Pavan,3,67,119,105,283,414,148,279,135,131
1620,5,Pavan,3,68,105,116,172,314,41,183,131,142
1621,5,Pavan,3,69,116,104,175,281,33,139,142,106
1622,5,Pavan,3,70,104,32,232,379,126,273,106,147
1623,5,Pavan,3,71,32,97,168,313,21,166,147,145
1624,5,Pavan,3,72,97,32,181,335,36,190,145,154
1625,5,Pavan,3,73,32,103,185,316,31,162,154,131
1626,5,Pavan,3,74,103,111,258,360,127,229,131,102
1627,5,Pavan,3,75,111,111,157,277,55,175,102,120
1628,5,Pavan,3,76,111,100,180,312,60,192,120,132
1629,5,Pavan,3,77,100,32,218,331,86,199,132,113
1630,5,Pavan,3,78,32,97,297,442,184,329,113,145
1631,5,Pavan,3,79,97,116,294,434,149,289,145,140
1632,5,Pavan,3,80,116,116,180,308,40,168,140,128
1633,5,Pavan,3,81,116,105,108,259,-20,131,128,151
1634,5,Pavan,3,82,105,116,168,297,17,146,151,129
1635,5,Pavan,3,83,116,117,160,300,31,171,129,140
1636,5,Pavan,3,84,117,100,1803,2003,1663,1863,140,200
1637,5,Pavan,3,85,100,101,132,293,-68,93,200,161
1638,5,Pavan,4,0,13,116,1268,1409,1157,1298,111,141
1639,5,Pavan,4,1,116,104,109,288,-32,147,141,179
1640,5,Pavan,4,2,104,101,286,408,107,229,179,122
1641,5,Pavan,4,3,101,32,141,301,19,179,122,160
1642,5,Pavan,4,4,32,98,279,411,119,251,160,132
1643,5,Pavan,4,5,98,101,153,265,21,133,132,112
1644,5,Pavan,4,6,101,116,412,581,300,469,112,169
1645,5,Pavan,4,7,116,115,51,209,-118,40,169,158
1646,5,Pavan,4,8,115,8,1592,1740,1434,1582,158,148
1647,5,Pavan,4,9,8,8,178,317,30,169,148,139
1648,5,Pavan,4,10,8,115,538,643,399,504,139,105
1649,5,Pavan,4,11,115,116,210,395,105,290,105,185
1650,5,Pavan,4,12,116,32,218,361,33,176,185,143
1651,5,Pavan,4,13,32,112,637,729,494,586,143,92
1652,5,Pavan,4,14,112,114,259,431,167,339,92,172
1653,5,Pavan,4,15,114,101,123,261,-49,89,172,138
1654,5,Pavan,4,16,101,112,490,594,352,456,138,104
1655,5,Pavan,4,17,112,101,145,284,41,180,104,139
1656,5,Pavan,4,18,101,114,261,384,122,245,139,123
1657,5,Pavan,4,19,114,97,427,558,304,435,123,131
1658,5,Pavan,4,20,97,116,263,431,132,300,131,168
1659,5,Pavan,4,21,116,105,789,1014,621,846,168,225
1660,5,Pavan,4,22,105,111,146,375,-79,150,225,229
1661,5,Pavan,4,23,111,110,1083,1247,854,1018,229,164
1662,5,Pavan,4,24,110,32,311,470,147,306,164,159
1663,5,Pavan,4,25,32,102,1100,1247,941,1088,159,147
1664,5,Pavan,4,26,102,111,191,375,44,228,147,184
1665,5,Pavan,4,27,111,114,253,417,69,233,184,164
1666,5,Pavan,4,28,114,32,244,392,80,228,164,148
1667,5,Pavan,4,29,32,116,219,390,71,242,148,171
1668,5,Pavan,4,30,116,111,326,507,155,336,171,181
1669,5,Pavan,4,31,111,109,280,384,99,203,181,104
1670,5,Pavan,4,32,109,109,162,298,58,194,104,136
1671,5,Pavan,4,33,109,111,167,309,31,173,136,142
1672,5,Pavan,4,34,111,114,269,417,127,275,142,148
1673,5,Pavan,4,35,114,111,167,301,19,153,148,134
1674,5,Pavan,4,36,111,119,420,549,286,415,134,129
1675,5,Pavan,4,37,119,32,242,376,113,247,129,134
1676,5,Pavan,4,38,32,105,598,773,464,639,134,175
1677,5,Pavan,4,39,105,115,259,392,84,217,175,133
1678,5,Pavan,4,40,115,32,168,311,35,178,133,143
1679,5,Pavan,4,41,32,100,175,318,32,175,143,143
1680,5,Pavan,4,42,100,111,219,463,76,320,143,244
1681,5,Pavan,4,43,111,105,192,301,-52,57,244,109
1682,5,Pavan,4,44,105,110,313,445,204,336,109,132
1683,5,Pavan,4,45,110,32,262,397,130,265,132,135
1684,5,Pavan,4,46,32,121,972,1133,837,998,135,161
1685,5,Pavan,4,47,121,111,219,431,58,270,161,212
1686,5,Pavan,4,48,111,117,248,387,36,175,212,139
1687,5,Pavan,4,49,117,114,520,669,381,530,139,149
1688,5,Pavan,4,50,114,32,319,467,170,318,149,148
1689,5,Pavan,4,51,32,98,523,646,375,498,148,123
1690,5,Pavan,4,52,98,101,233,361,110,238,123,128
1691,5,Pavan,4,53,101,115,255,382,127,254,128,127
1692,5,Pavan,4,54,115,116,234,374,107,247,127,140
1693,5,Pavan,4,55,116,32,441,565,301,425,140,124
1694,5,Pavan,4,56,32,116,376,520,252,396,124,144
1695,5,Pavan,4,57,116,111,267,393,123,249,144,126
1696,5,Pavan,4,58,111,100,484,691,358,565,126,207
1697,5,Pavan,4,59,100,97,146,335,-61,128,207,189
1698,5,Pavan,4,60,97,121,140,296,-49,107,189,156
1699,5,Pavan,4,61,121,8,5952,6038,5796,5882,156,86
1700,5,Pavan,4,62,8,114,3383,3530,3297,3444,86,147
1701,5,Pavan,4,63,114,103,5549,5704,5402,5557,147,155
1702,5,Pavan,4,64,103,8,8305,8485,8150,8330,155,180
1703,5,Pavan,4,65,8,97,131,276,-49,96,180,145
1704,6,Aniket,0,0,97,110,241,430,103,292,138,189
1705,6,Aniket,0,1,110,121,273,405,84,216,189,132
1706,6,Aniket,0,2,121,32,2325,2458,2193,2326,132,133
1707,6,Aniket,0,3,32,116,694,823,561,690,133,129
1708,6,Aniket,0,4,116,114,168,292,39,163,129,124
1709,6,Aniket,0,5,114,97,187,339,63,215,124,152
1710,6,Aniket,0,6,97,110,1785,1893,1633,1741,152,108
1711,6,Aniket,0,7,110,115,403,534,295,426,108,131
1712,6,Aniket,0,8,115,105,250,374,119,243,131,124
1713,6,Aniket,0,9,105,116,519,646,395,522,124,127
1714,6,Aniket,0,10,116,105,198,397,71,270,127,199
1715,6,Aniket,0,11,105,111,837,955,638,756,199,118
1716,6,Aniket,0,12,111,110,298,406,180,288,118,108
1717,6,Aniket,0,13,110,32,719,858,611,750,108,139
1718,6,Aniket,0,14,32,105,673,788,534,649,139,115
1719,6,Aniket,0,15,105,115,244,368,129,253,115,124
1720,6,Aniket,0,16,115,32,178,310,54,186,124,132
1721,6,Aniket,0,17,32,101,402,516,270,384,132,114
1722,6,Aniket,0,18,101,97,152,299,38,185,114,147
1723,6,Aniket,0,19,97,115,278,415,131,268,147,137
1724,6,Aniket,0,20,115,105,332,456,195,319,137,124
1725,6,Aniket,0,21,105,101,319,452,195,328,124,133
1726,6,Aniket,0,22,101,114,151,260,18,127,133,109
1727,6,Aniket,0,23,114,32,405,536,296,427,109,131
1728,6,Aniket,0,24,32,105,1074,1181,943,1050,131,107
1729,6,Aniket,0,25,105,102,273,395,166,288,107,122
1730,6,Aniket,0,26,102,32,160,285,38,163,122,125
1731,6,Aniket,0,27,32,121,362,467,237,342,125,105
1732,6,Aniket,0,28,121,111,580,692,475,587,105,112
1733,6,Aniket,0,29,111,117,172,298,60,186,112,126
1734,6,Aniket,0,30,117,32,273,397,147,271,126,124
1735,6,Aniket,0,31,32,98,554,652,430,528,124,98
1736,6,Aniket,0,32,98,101,175,306,77,208,98,131
1737,6,Aniket,0,33,101,108,322,450,191,319,131,128
1738,6,Aniket,0,34,108,105,236,336,108,208,128,100
1739,6,Aniket,0,35,105,101,201,371,101,271,100,170
1740,6,Aniket,0,36,101,118,430,540,260,370,170,110
1741,6,Aniket,0,37,118,101,147,283,37,173,110,136
1742,6,Aniket,0,38,101,32,499,622,363,486,136,123
1743,6,Aniket,0,39,32,105,553,680,430,557,123,127
1744,6,Aniket,0,40,105,110,210,324,83,197,127,114
1745,6,Aniket,0,41,110,32,204,325,90,211,114,121
1746,6,Aniket,0,42,32,121,569,710,448,589,121,141
1747,6,Aniket,0,43,121,111,205,330,64,189,141,125
1748,6,Aniket,0,44,111,117,635,751,510,626,125,116
1749,6,Aniket,0,45,117,114,210,331,94,215,116,121
1750,6,Aniket,0,46,114,115,557,720,436,599,121,163
1751,6,Aniket,0,47,115,101,277,450,114,287,163,173
1752,6,Aniket,0,48,101,108,376,505,203,332,173,129
1753,6,Aniket,0,49,108,102,200,316,71,187,129,116
1754,6,Aniket,0,50,102,32,628,744,512,628,116,116
1755,6,Aniket,0,51,32,97,596,759,480,643,116,163
1756,6,Aniket,0,52,97,110,394,503,231,340,163,109
1757,6,Aniket,0,53,110,100,142,268,33,159,109,126
1758,6,Aniket,0,54,100,32,158,276,32,150,126,118
1759,6,Aniket,0,55,32,121,733,843,615,725,118,110
1760,6,Aniket,0,56,121,111,226,350,116,240,110,124
1761,6,Aniket,0,57,111,117,238,348,114,224,124,110
1762,6,Aniket,0,58,117,114,318,458,208,348,110,140
1763,6,Aniket,0,59,114,32,208,336,68,196,140,128
1764,6,Aniket,0,60,32,116,292,407,164,279,128,115
1765,6,Aniket,0,61,116,97,222,393,107,278,115,171
1766,6,Aniket,0,62,97,108,311,435,140,264,171,124
1767,6,Aniket,0,63,108,101,173,354,49,230,124,181
1768,6,Aniket,0,64,101,110,239,356,58,175,181,117
1769,6,Aniket,0,65,110,116,557,698,440,581,117,141
1770,6,Aniket,1,0,13,105,1634,1749,1534,1649,100,115
1771,6,Aniket,1,1,105,116,208,349,93,234,115,141
1772,6,Aniket,1,2,116,32,188,309,47,168,141,121
1773,6,Aniket,1,3,32,100,586,729,465,608,121,143
1774,6,Aniket,1,4,100,111,219,326,76,183,143,107
1775,6,Aniket,1,5,111,101,325,473,218,366,107,148
1776,6,Aniket,1,6,101,115,312,421,164,273,148,109
1777,6,Aniket,1,7,115,32,205,340,96,231,109,135
1778,6,Aniket,1,8,32,110,971,1075,836,940,135,104
1779,6,Aniket,1,9,110,111,506,614,402,510,104,108
1780,6,Aniket,1,10,111,116,148,272,40,164,108,124
1781,6,Aniket,1,11,116,32,180,314,56,190,124,134
1782,6,Aniket,1,12,32,109,285,408,151,274,134,123
1783,6,Aniket,1,13,109,97,476,642,353,519,123,166
1784,6,Aniket,1,14,97,116,240,365,74,199,166,125
1785,6,Aniket,1,15,116,116,180,321,55,196,125,141
1786,6,Aniket,1,16,116,101,238,377,97,236,141,139
1787,6,Aniket,1,17,101,114,157,269,18,130,139,112
1788,6,Aniket,1,18,114,32,609,739,497,627,112,130
1789,6,Aniket,1,19,32,104,1477,1603,1347,1473,130,126
1790,6,Aniket,1,20,104,111,642,757,516,631,126,115
1791,6,Aniket,1,21,111,119,240,389,125,274,115,149
1792,6,Aniket,1,22,119,32,254,388,105,239,149,134
1793,6,Aniket,1,23,32,115,1418,1573,1284,1439,134,155
1794,6,Aniket,1,24,115,108,209,335,54,180,155,126
1795,6,Aniket,1,25,108,111,201,298,75,172,126,97
1796,6,Aniket,1,26,111,119,240,383,143,286,97,143
1797,6,Aniket,1,27,119,108,250,384,107,241,143,134
1798,6,Aniket,1,28,108,121,469,554,335,420,134,85
1799,6,Aniket,1,29,121,32,153,277,68,192,85,124
1800,6,Aniket,1,30,32,121,1142,1270,1018,1146,124,128
1801,6,Aniket,1,31,121,111,226,349,98,221,128,123
1802,6,Aniket,1,32,111,117,202,317,79,194,123,115
1803,6,Aniket,1,33,117,32,147,269,32,154,115,122
1804,6,Aniket,1,34,32,103,512,672,390,550,122,160
1805,6,Aniket,1,35,103,111,212,293,52,133,160,81
1806,6,Aniket,1,36,111,32,338,434,257,353,81,96
1807,6,Aniket,1,37,32,97,911,1048,815,952,96,137
1808,6,Aniket,1,38,97,115,262,396,125,259,137,134
1809,6,Aniket,1,39,115,32,199,326,65,192,134,127
1810,6,Aniket,1,40,32,108,639,764,512,637,127,125
1811,6,Aniket,1,41,108,111,196,296,71,171,125,100
1812,6,Aniket,1,42,111,110,234,354,134,254,100,120
1813,6,Aniket,1,43,110,103,274,385,154,265,120,111
1814,6,Aniket,1,44,103,32,154,277,43,166,111,123
1815,6,Aniket,1,45,32,97,833,951,710,828,123,118
1816,6,Aniket,1,46,97,115,229,362,111,244,118,133
1817,6,Aniket,1,47,115,32,327,451,194,318,133,124
1818,6,Aniket,1,48,32,121,769,891,645,767,124,122
1819,6,Aniket,1,49,121,111,354,471,232,349,122,117
1820,6,Aniket,1,50,111,117,208,341,91,224,117,133
1821,6,Aniket,1,51,117,32,164,283,31,150,133,119
1822,6,Aniket,1,52,32,100,561,696,442,577,119,135
1823,6,Aniket,1,53,100,111,278,405,143,270,135,127
1824,6,Aniket,1,54,111,32,621,720,494,593,127,99
1825,6,Aniket,1,55,32,110,510,636,411,537,99,126
1826,6,Aniket,1,56,110,111,464,562,338,436,126,98
1827,6,Aniket,1,57,111,116,137,265,39,167,98,128
1828,6,Aniket,1,58,116,32,183,316,55,188,128,133
1829,6,Aniket,1,59,32,115,470,596,337,463,133,126
1830,6,Aniket,1,60,115,116,271,411,145,285,126,140
1831,6,Aniket,1,61,116,111,288,475,148,335,140,187
1832,6,Aniket,1,62,111,112,145,286,-42,99,187,141
1833,6,Aniket,2,0,13,119,1042,1188,950,1096,92,146
1834,6,Aniket,2,1,119,101,222,361,76,215,146,139
1835,6,Aniket,2,2,101,32,232,352,93,213,139,120
1836,6,Aniket,2,3,32,107,451,564,331,444,120,113
1837,6,Aniket,2,4,107,110,206,316,93,203,113,110
1838,6,Aniket,2,5,110,111,537,640,427,530,110,103
1839,6,Aniket,2,6,111,119,282,407,179,304,103,125
1840,6,Aniket,2,7,119,119,1127,1262,1002,1137,125,135
1841,6,Aniket,2,8,119,104,186,310,51,175,135,124
1842,6,Aniket,2,9,104,97,154,386,30,262,124,232
1843,6,Aniket,2,10,97,116,183,301,-49,69,232,118
1844,6,Aniket,2,11,116,32,309,443,191,325,118,134
1845,6,Aniket,2,12,32,8,979,1085,845,951,134,106
1846,6,Aniket,2,13,8,8,183,274,77,168,106,91
1847,6,Aniket,2,14,8,8,173,285,82,194,91,112
1848,6,Aniket,2,15,8,8,198,315,86,203,112,117
1849,6,Aniket,2,16,8,8,196,288,79,171,117,92
1850,6,Aniket,2,17,8,32,2188,2360,2096,2268,92,172
1851,6,Aniket,2,18,32,119,642,793,470,621,172,151
1852,6,Aniket,2,19,119,104,212,338,61,187,151,126
1853,6,Aniket,2,20,104,97,501,598,375,472,126,97
1854,6,Aniket,2,21,97,116,353,468,256,371,97,115
1855,6,Aniket,2,22,116,32,670,789,555,674,115,119
1856,6,Aniket,2,23,32,119,491,626,372,507,119,135
1857,6,Aniket,2,24,119,101,225,355,90,220,135,130
1858,6,Aniket,2,25,101,32,480,624,350,494,130,144
1859,6,Aniket,2,26,32,97,188,359,44,215,144,171
1860,6,Aniket,2,27,97,114,217,344,46,173,171,127
1861,6,Aniket,2,28,114,101,166,319,39,192,127,153
1862,6,Aniket,2,29,101,32,310,456,157,303,153,146
1863,6,Aniket,2,30,32,98,943,1063,797,917,146,120
1864,6,Aniket,2,31,98,117,338,450,218,330,120,112
1865,6,Aniket,2,32,117,116,173,294,61,182,112,121
1866,6,Aniket,2,33,116,32,157,284,36,163,121,127
1867,6,Aniket,2,34,32,107,1421,1546,1294,1419,127,125
1868,6,Aniket,2,35,107,110,233,363,108,238,125,130
1869,6,Aniket,2,36,110,111,337,458,207,328,130,121
1870,6,Aniket,2,37,111,119,306,421,185,300,121,115
1871,6,Aniket,2,38,119,32,208,326,93,211,115,118
1872,6,Aniket,2,39,32,110,1232,1349,1114,1231,118,117
1873,6,Aniket,2,40,110,111,405,527,288,410,117,122
1874,6,Aniket,2,41,111,116,223,347,101,225,122,124
1875,6,Aniket,2,42,116,32,185,312,61,188,124,127
1876,6,Aniket,2,43,32,119,733,895,606,768,127,162
1877,6,Aniket,2,44,119,104,146,287,-16,125,162,141
1878,6,Aniket,2,45,104,97,246,414,105,273,141,168
1879,6,Aniket,2,46,97,116,116,226,-52,58,168,110
1880,6,Aniket,2,47,116,32,768,873,658,763,110,105
1881,6,Aniket,2,48,32,119,2948,3104,2843,2999,105,156
1882,6,Aniket,2,49,119,101,251,374,95,218,156,123
1883,6,Aniket,2,50,101,32,296,387,173,264,123,91
1884,6,Aniket,2,51,32,109,569,685,478,594,91,116
1885,6,Aniket,2,52,109,97,179,324,63,208,116,145
1886,6,Aniket,2,53,97,121,206,306,61,161,145,100
1887,6,Aniket,2,54,121,32,235,368,135,268,100,133
1888,6,Aniket,2,55,32,98,320,426,187,293,133,106
1889,6,Aniket,2,56,98,101,136,265,30,159,106,129
1890,6,Aniket,3,0,13,121,1228,1337,1124,1233,104,109
1891,6,Aniket,3,1,121,111,391,510,282,401,109,119
1892,6,Aniket,3,2,111,117,175,299,56,180,119,124
1893,6,Aniket,3,3,117,32,188,312,64,188,124,124
1894,6,Aniket,3,4,32,99,665,900,541,776,124,235
1895,6,Aniket,3,5,99,97,186,484,-49,249,235,298
1896,6,Aniket,3,6,97,116,662,786,364,488,298,124
1897,6,Aniket,3,7,116,8,804,944,680,820,124,140
1898,6,Aniket,3,8,8,110,476,595,336,455,140,119
1899,6,Aniket,3,9,110,116,172,300,53,181,119,128
1900,6,Aniket,3,10,116,32,294,420,166,292,128,126
1901,6,Aniket,3,11,32,97,966,1116,840,990,126,150
1902,6,Aniket,3,12,97,108,311,425,161,275,150,114
1903,6,Aniket,3,13,108,119,183,350,69,236,114,167
1904,6,Aniket,3,14,119,97,248,409,81,242,167,161
1905,6,Aniket,3,15,97,121,221,341,60,180,161,120
1906,6,Aniket,3,16,121,115,162,326,42,206,120,164
1907,6,Aniket,3,17,115,32,520,631,356,467,164,111
1908,6,Aniket,3,18,32,104,956,1069,845,958,111,113
1909,6,Aniket,3,19,104,97,146,343,33,230,113,197
1910,6,Aniket,3,20,97,118,180,292,-17,95,197,112
1911,6,Aniket,3,21,118,101,144,286,32,174,112,142
1912,6,Aniket,3,22,101,32,161,287,19,145,142,126
1913,6,Aniket,3,23,32,97,147,302,21,176,126,155
1914,6,Aniket,3,24,97,32,199,296,44,141,155,97
1915,6,Aniket,3,25,32,103,1016,1146,919,1049,97,130
1916,6,Aniket,3,26,103,111,243,344,113,214,130,101
1917,6,Aniket,3,27,111,111,164,275,63,174,101,111
1918,6,Aniket,3,28,111,100,231,377,120,266,111,146
1919,6,Aniket,3,29,100,32,179,308,33,162,146,129
1920,6,Aniket,3,30,32,100,457,666,328,537,129,209
1921,6,Aniket,3,31,100,20,255,395,46,186,209,140
1922,6,Aniket,3,32,20,20,989,1128,849,988,140,139
1923,6,Aniket,3,33,20,97,308,457,169,318,139,149
1924,6,Aniket,3,34,97,121,169,269,20,120,149,100
1925,6,Aniket,3,35,121,32,721,847,621,747,100,126
1926,6,Aniket,3,36,32,98,480,618,354,492,126,138
1927,6,Aniket,3,37,98,117,397,499,259,361,138,102
1928,6,Aniket,3,38,117,116,194,328,92,226,102,134
1929,6,Aniket,3,39,116,32,174,302,40,168,134,128
1930,6,Aniket,3,40,32,121,392,534,264,406,128,142
1931,6,Aniket,3,41,121,111,175,317,33,175,142,142
1932,6,Aniket,3,42,111,117,184,307,42,165,142,123
1933,6,Aniket,3,43,117,32,222,348,99,225,123,126
1934,6,Aniket,3,44,32,99,865,1114,739,988,126,249
1935,6,Aniket,3,45,99,97,219,383,-30,134,249,164
1936,6,Aniket,3,46,97,110,208,312,44,148,164,104
1937,6,Aniket,3,47,110,32,203,310,99,206,104,107
1938,6,Aniket,3,48,32,97,1668,1834,1561,1727,107,166
1939,6,Aniket,3,49,97,108,258,373,92,207,166,115
1940,6,Aniket,3,50,108,119,431,590,316,475,115,159
1941,6,Aniket,3,51,119,97,246,400,87,241,159,154
1942,6,Aniket,3,52,97,121,186,289,32,135,154,103
1943,6,Aniket,3,53,121,115,123,262,20,159,103,139
1944,6,Aniket,3,54,115,32,219,353,80,214,139,134
1945,6,Aniket,3,55,32,102,1174,1336,1040,1202,134,162
1946,6,Aniket,3,56,102,97,209,404,47,242,162,195
1947,6,Aniket,3,57,97,99,176,319,-19,124,195,143
1948,6,Aniket,3,58,99,101,159,316,16,173,143,157
1949,6,Aniket,3,59,101,32,200,328,43,171,157,128
1950,6,Aniket,3,60,32,97,236,374,108,246,128,138
1951,6,Aniket,3,61,97,32,170,296,32,158,138,126
1952,6,Aniket,3,62,32,98,640,796,514,670,126,156
1953,6,Aniket,3,63,98,97,113,264,-43,108,156,151
1954,6,Aniket,3,64,97,100,943,1088,792,937,151,145
1955,6,Aniket,3,65,100,32,165,307,20,162,145,142
1956,6,Aniket,3,66,32,100,539,738,397,596,142,199
1957,6,Aniket,3,67,100,97,219,394,20,195,199,175
1958,6,Aniket,3,68,97,121,156,256,-19,81,175,100
1959,6,Aniket,3,69,121,32,735,859,635,759,100,124
1960,6,Aniket,3,70,32,119,486,633,362,509,124,147
1961,6,Aniket,3,71,119,105,458,568,311,421,147,110
1962,6,Aniket,3,72,105,116,200,339,90,229,110,139
1963,6,Aniket,3,73,116,104,120,244,-19,105,139,124
1964,6,Aniket,3,74,104,32,266,410,142,286,124,144
1965,6,Aniket,3,75,32,97,213,359,69,215,144,146
1966,6,Aniket,3,76,97,32,267,395,121,249,146,128
1967,6,Aniket,3,77,32,103,665,774,537,646,128,109
1968,6,Aniket,3,78,103,111,221,321,112,212,109,100
1969,6,Aniket,3,79,111,111,155,260,55,160,100,105
1970,6,Aniket,3,80,111,100,210,358,105,253,105,148
1971,6,Aniket,3,81,100,32,180,271,32,123,148,91
1972,6,Aniket,3,82,32,97,231,402,140,311,91,171
1973,6,Aniket,3,83,97,116,193,287,22,116,171,94
1974,6,Aniket,3,84,116,116,416,523,322,429,94,107
1975,6,Aniket,3,85,116,105,777,891,670,784,107,114
1976,6,Aniket,3,86,105,116,391,516,277,402,114,125
1977,6,Aniket,3,87,116,117,199,317,74,192,125,118
1978,6,Aniket,3,88,117,100,425,616,307,498,118,191
1979,6,Aniket,3,89,100,101,174,390,-17,199,191,216
1980,6,Aniket,4,0,13,116,1108,1268,992,1152,116,160
1981,6,Aniket,4,1,116,104,139,244,-21,84,160,105
1982,6,Aniket,4,2,104,101,161,351,56,246,105,190
1983,6,Aniket,4,3,101,32,231,342,41,152,190,111
1984,6,Aniket,4,4,32,98,692,874,581,763,111,182
1985,6,Aniket,4,5,98,101,286,445,104,263,182,159
1986,6,Aniket,4,6,101,115,281,401,122,242,159,120
1987,6,Aniket,4,7,115,116,151,254,31,134,120,103
1988,6,Aniket,4,8,116,32,250,398,147,295,103,148
1989,6,Aniket,4,9,32,112,800,904,652,756,148,104
1990,6,Aniket,4,10,112,114,226,458,122,354,104,232
1991,6,Aniket,4,11,114,101,249,394,17,162,232,145
1992,6,Aniket,4,12,101,112,175,273,30,128,145,98
1993,6,Aniket,4,13,112,97,930,1064,832,966,98,134
1994,6,Aniket,4,14,97,114,241,399,107,265,134,158
1995,6,Aniket,4,15,114,97,179,336,21,178,158,157
1996,6,Aniket,4,16,97,116,269,417,112,260,157,148
1997,6,Aniket,4,17,116,105,181,365,33,217,148,184
1998,6,Aniket,4,18,105,111,136,286,-48,102,184,150
1999,6,Aniket,4,19,111,110,242,377,92,227,150,135
2000,6,Aniket,4,20,110,32,216,325,81,190,135,109
2001,6,Aniket,4,21,32,102,878,1021,769,912,109,143
2002,6,Aniket,4,22,102,111,188,295,45,152,143,107
2003,6,Aniket,4,23,111,114,140,288,33,181,107,148
2004,6,Aniket,4,24,114,32,181,276,33,128,148,95
2005,6,Aniket,4,25,32,116,162,287,67,192,95,125
2006,6,Aniket,4,26,116,111,223,340,98,215,125,117
2007,6,Aniket,4,27,111,109,229,343,112,226,117,114
2008,6,Aniket,4,28,109,109,179,290,65,176,114,111
2009,6,Aniket,4,29,109,111,168,297,57,186,111,129
2010,6,Aniket,4,30,111,114,276,398,147,269,129,122
2011,6,Aniket,4,31,114,114,187,283,65,161,122,96
2012,6,Aniket,4,32,114,111,143,246,47,150,96,103
2013,6,Aniket,4,33,111,119,403,532,300,429,103,129
2014,6,Aniket,4,34,119,32,737,859,608,730,129,122
2015,6,Aniket,4,35,32,8,3004,3102,2882,2980,122,98
2016,6,Aniket,4,36,8,8,174,281,76,183,98,107
2017,6,Aniket,4,37,8,8,165,266,58,159,107,101
2018,6,Aniket,4,38,8,8,156,260,55,159,101,104
2019,6,Aniket,4,39,8,8,170,272,66,168,104,102
2020,6,Aniket,4,40,8,8,178,275,76,173,102,97
2021,6,Aniket,4,41,8,8,400,491,303,394,97,91
2022,6,Aniket,4,42,8,111,534,641,443,550,91,107
2023,6,Aniket,4,43,111,114,438,535,331,428,107,97
2024,6,Aniket,4,44,114,114,170,268,73,171,97,98
2025,6,Aniket,4,45,114,111,176,286,78,188,98,110
2026,6,Aniket,4,46,111,119,420,560,310,450,110,140
2027,6,Aniket,4,47,119,32,553,677,413,537,140,124
2028,6,Aniket,4,48,32,105,682,776,558,652,124,94
2029,6,Aniket,4,49,105,115,208,337,114,243,94,129
2030,6,Aniket,4,50,115,32,238,352,109,223,129,114
2031,6,Aniket,4,51,32,100,5342,5504,5228,5390,114,162
2032,6,Aniket,4,52,100,111,200,373,38,211,162,173
2033,6,Aniket,4,53,111,105,141,264,-32,91,173,123
2034,6,Aniket,4,54,105,110,420,552,297,429,123,132
2035,6,Aniket,4,55,110,103,333,440,201,308,132,107
2036,6,Aniket,4,56,103,32,706,823,599,716,107,117
2037,6,Aniket,4,57,32,121,845,960,728,843,117,115
2038,6,Aniket,4,58,121,111,146,261,31,146,115,115
2039,6,Aniket,4,59,111,117,218,326,103,211,115,108
2040,6,Aniket,4,60,117,114,349,484,241,376,108,135
2041,6,Aniket,4,61,114,32,235,349,100,214,135,114
2042,6,Aniket,4,62,32,98,1216,1345,1102,1231,114,129
2043,6,Aniket,4,63,98,101,161,312,32,183,129,151
2044,6,Aniket,4,64,101,115,233,398,82,247,151,165
2045,6,Aniket,4,65,115,116,134,243,-31,78,165,109
2046,6,Aniket,4,66,116,32,293,415,184,306,109,122
2047,6,Aniket,4,67,32,116,627,763,505,641,122,136
2048,6,Aniket,4,68,116,111,217,333,81,197,136,116
2049,6,Aniket,4,69,111,100,352,541,236,425,116,189
2050,6,Aniket,4,70,100,97,208,388,19,199,189,180
2051,6,Aniket,4,71,97,121,216,310,36,130,180,94
2402,8,Laxmi1,0,0,97,110,184,313,-33,96,217,129
2403,8,Laxmi1,0,1,110,121,245,366,116,237,129,121
2404,8,Laxmi1,0,2,121,32,269,393,148,272,121,124
2405,8,Laxmi1,0,3,32,116,556,677,432,553,124,121
2406,8,Laxmi1,0,4,116,114,181,290,60,169,121,109
2407,8,Laxmi1,0,5,114,97,211,361,102,252,109,150
2408,8,Laxmi1,0,6,97,110,795,911,645,761,150,116
2409,8,Laxmi1,0,7,110,115,239,384,123,268,116,145
2410,8,Laxmi1,0,8,115,105,558,635,413,490,145,77
2411,8,Laxmi1,0,9,105,116,260,325,183,248,77,65
2412,8,Laxmi1,0,10,116,105,582,682,517,617,65,100
2413,8,Laxmi1,0,11,105,111,228,322,128,222,100,94
2414,8,Laxmi1,0,12,111,110,403,498,309,404,94,95
2415,8,Laxmi1,0,13,110,32,203,279,108,184,95,76
2416,8,Laxmi1,0,14,32,105,386,478,310,402,76,92
2417,8,Laxmi1,0,15,105,115,312,455,220,363,92,143
2418,8,Laxmi1,0,16,115,32,125,254,-18,111,143,129
2419,8,Laxmi1,0,17,32,101,323,453,194,324,129,130
2420,8,Laxmi1,0,18,101,97,326,468,196,338,130,142
2421,8,Laxmi1,0,19,97,115,248,397,106,255,142,149
2422,8,Laxmi1,0,20,115,105,311,401,162,252,149,90
2423,8,Laxmi1,0,21,105,101,280,429,190,339,90,149
2424,8,Laxmi1,0,22,101,114,246,342,97,193,149,96
2425,8,Laxmi1,0,23,114,32,769,977,673,881,96,208
2426,8,Laxmi1,0,24,32,105,836,946,628,738,208,110
2427,8,Laxmi1,0,25,105,102,389,518,279,408,110,129
2428,8,Laxmi1,0,26,102,32,165,229,36,100,129,64
2429,8,Laxmi1,0,27,32,121,252,338,188,274,64,86
2430,8,Laxmi1,0,28,121,111,515,636,429,550,86,121
2431,8,Laxmi1,0,29,111,117,698,775,577,654,121,77
2432,8,Laxmi1,0,30,117,32,270,373,193,296,77,103
2433,8,Laxmi1,0,31,32,98,935,1043,832,940,103,108
2434,8,Laxmi1,0,32,98,101,433,589,325,481,108,156
2435,8,Laxmi1,0,33,101,108,362,482,206,326,156,120
2436,8,Laxmi1,0,34,108,105,272,361,152,241,120,89
2437,8,Laxmi1,0,35,105,101,210,381,121,292,89,171
2438,8,Laxmi1,0,36,101,118,412,515,241,344,171,103
2439,8,Laxmi1,0,37,118,101,214,350,111,247,103,136
2440,8,Laxmi1,0,38,101,32,226,383,90,247,136,157
2441,8,Laxmi1,0,39,32,105,664,769,507,612,157,105
2442,8,Laxmi1,0,40,105,110,295,400,190,295,105,105
2443,8,Laxmi1,0,41,110,32,198,285,93,180,105,87
2444,8,Laxmi1,0,42,32,121,376,481,289,394,87,105
2445,8,Laxmi1,0,43,121,111,535,651,430,546,105,116
2446,8,Laxmi1,0,44,111,117,355,465,239,349,116,110
2447,8,Laxmi1,0,45,117,114,338,458,228,348,110,120
2448,8,Laxmi1,0,46,114,115,344,490,224,370,120,146
2449,8,Laxmi1,0,47,115,101,241,369,95,223,146,128
2450,8,Laxmi1,0,48,101,108,335,458,207,330,128,123
2451,8,Laxmi1,0,49,108,102,682,821,559,698,123,139
2452,8,Laxmi1,0,50,102,32,1162,1327,1023,1188,139,165
2453,8,Laxmi1,0,51,32,97,610,756,445,591,165,146
2454,8,Laxmi1,0,52,97,110,213,333,67,187,146,120
2455,8,Laxmi1,0,53,110,100,338,468,218,348,120,130
2456,8,Laxmi1,0,54,100,32,168,313,38,183,130,145
2457,8,Laxmi1,0,55,32,121,868,979,723,834,145,111
2458,8,Laxmi1,0,56,121,111,471,581,360,470,111,110
2459,8,Laxmi1,0,57,111,117,247,324,137,214,110,77
2460,8,Laxmi1,0,58,117,114,386,536,309,459,77,150
2461,8,Laxmi1,0,59,114,32,169,289,19,139,150,120
2462,8,Laxmi1,0,60,32,116,313,432,193,312,120,119
2463,8,Laxmi1,0,61,116,97,210,356,91,237,119,146
2464,8,Laxmi1,0,62,97,108,404,533,258,387,146,129
2465,8,Laxmi1,0,63,108,101,311,447,182,318,129,136
2466,8,Laxmi1,0,64,101,110,407,518,271,382,136,111
2467,8,Laxmi1,0,65,110,116,360,461,249,350,111,101
2468,8,Laxmi1,1,0,13,105,1295,1419,1186,1310,109,124
2469,8,Laxmi1,1,1,105,116,263,416,139,292,124,153
2470,8,Laxmi1,1,2,116,32,224,343,71,190,153,119
2471,8,Laxmi1,1,3,32,100,442,589,323,470,119,147
2472,8,Laxmi1,1,4,100,111,246,361,99,214,147,115
2473,8,Laxmi1,1,5,111,101,214,336,99,221,115,122
2474,8,Laxmi1,1,6,101,115,282,429,160,307,122,147
2475,8,Laxmi1,1,7,115,32,1070,1188,923,1041,147,118
2476,8,Laxmi1,1,8,32,110,417,502,299,384,118,85
2477,8,Laxmi1,1,9,110,111,377,465,292,380,85,88
2478,8,Laxmi1,1,10,111,116,436,583,348,495,88,147
2479,8,Laxmi1,1,11,116,32,207,310,60,163,147,103
2480,8,Laxmi1,1,12,32,109,272,370,169,267,103,98
2481,8,Laxmi1,1,13,109,97,299,441,201,343,98,142
2482,8,Laxmi1,1,14,97,116,315,406,173,264,142,91
2483,8,Laxmi1,1,15,116,116,137,234,46,143,91,97
2484,8,Laxmi1,1,16,116,101,265,360,168,263,97,95
2485,8,Laxmi1,1,17,101,114,187,300,92,205,95,113
2486,8,Laxmi1,1,18,114,32,440,588,327,475,113,148
2487,8,Laxmi1,1,19,32,104,617,704,469,556,148,87
2488,8,Laxmi1,1,20,104,111,458,558,371,471,87,100
2489,8,Laxmi1,1,21,111,119,712,845,612,745,100,133
2490,8,Laxmi1,1,22,119,32,241,380,108,247,133,139
2491,8,Laxmi1,1,23,32,115,835,988,696,849,139,153
2492,8,Laxmi1,1,24,115,108,422,537,269,384,153,115
2493,8,Laxmi1,1,25,108,111,206,310,91,195,115,104
2494,8,Laxmi1,1,26,111,119,945,1115,841,1011,104,170
2495,8,Laxmi1,1,27,119,108,289,423,119,253,170,134
2496,8,Laxmi1,1,28,108,121,499,590,365,456,134,91
2497,8,Laxmi1,1,29,121,32,630,795,539,704,91,165
2498,8,Laxmi1,1,30,32,121,658,743,493,578,165,85
2499,8,Laxmi1,1,31,121,111,400,521,315,436,85,121
2500,8,Laxmi1,1,32,111,117,276,350,155,229,121,74
2501,8,Laxmi1,1,33,117,32,261,368,187,294,74,107
2502,8,Laxmi1,1,34,32,103,549,686,442,579,107,137
2503,8,Laxmi1,1,35,103,111,168,288,31,151,137,120
2504,8,Laxmi1,1,36,111,32,280,434,160,314,120,154
2505,8,Laxmi1,1,37,32,97,699,832,545,678,154,133
2506,8,Laxmi1,1,38,97,115,242,372,109,239,133,130
2507,8,Laxmi1,1,39,115,32,164,249,34,119,130,85
2508,8,Laxmi1,1,40,32,108,413,509,328,424,85,96
2509,8,Laxmi1,1,41,108,111,170,282,74,186,96,112
2510,8,Laxmi1,1,42,111,110,363,466,251,354,112,103
2511,8,Laxmi1,1,43,110,103,337,440,234,337,103,103
2512,8,Laxmi1,1,44,103,32,260,379,157,276,103,119
2513,8,Laxmi1,1,45,32,97,795,928,676,809,119,133
2514,8,Laxmi1,1,46,97,115,241,374,108,241,133,133
2515,8,Laxmi1,1,47,115,32,170,275,37,142,133,105
2516,8,Laxmi1,1,48,32,121,440,518,335,413,105,78
2517,8,Laxmi1,1,49,121,111,593,694,515,616,78,101
2518,8,Laxmi1,1,50,111,117,849,970,748,869,101,121
2519,8,Laxmi1,1,51,117,32,783,931,662,810,121,148
2520,8,Laxmi1,1,52,32,100,1402,1537,1254,1389,148,135
2521,8,Laxmi1,1,53,100,111,230,342,95,207,135,112
2522,8,Laxmi1,1,54,111,110,1114,1203,1002,1091,112,89
2523,8,Laxmi1,1,55,110,111,426,528,337,439,89,102
2524,8,Laxmi1,1,56,111,116,384,481,282,379,102,97
2525,8,Laxmi1,1,57,116,32,295,391,198,294,97,96
2526,8,Laxmi1,1,58,32,115,949,1085,853,989,96,136
2527,8,Laxmi1,1,59,115,116,235,327,99,191,136,92
2528,8,Laxmi1,1,60,116,111,484,579,392,487,92,95
2529,8,Laxmi1,1,61,111,112,213,317,118,222,95,104
2530,8,Laxmi1,1,62,112,37,1593,1743,1489,1639,104,150
2531,8,Laxmi1,1,63,37,37,220,320,70,170,150,100
2532,8,Laxmi1,1,64,37,37,173,253,73,153,100,80
2533,8,Laxmi1,1,65,37,37,153,252,73,172,80,99
2534,8,Laxmi1,1,66,37,37,185,275,86,176,99,90
2535,8,Laxmi1,1,67,37,37,166,263,76,173,90,97
2536,8,Laxmi1,1,68,37,37,196,267,99,170,97,71
2537,8,Laxmi1,1,69,37,37,388,501,317,430,71,113
2538,8,Laxmi1,1,70,37,32,899,996,786,883,113,97
2539,8,Laxmi1,1,71,32,39,488,1204,391,1107,97,716
2540,8,Laxmi1,1,72,39,39,497,716,-219,0,716,219
2541,8,Laxmi1,1,73,39,39,31,219,-188,0,219,188
2542,8,Laxmi1,1,74,39,39,31,188,-157,0,188,157
2543,8,Laxmi1,1,75,39,39,31,157,-126,0,157,126
2544,8,Laxmi1,1,76,39,39,30,126,-96,0,126,96
2545,8,Laxmi1,1,77,39,39,29,96,-67,0,96,67
2546,8,Laxmi1,1,78,39,39,31,67,-36,0,67,36
2547,8,Laxmi1,1,79,39,39,28,36,-8,0,36,8
2548,8,Laxmi1,2,0,13,119,2112,2265,2007,2160,105,153
2549,8,Laxmi1,2,1,119,101,224,354,71,201,153,130
2550,8,Laxmi1,2,2,101,32,183,290,53,160,130,107
2551,8,Laxmi1,2,3,32,107,537,647,430,540,107,110
2552,8,Laxmi1,2,4,107,110,536,620,426,510,110,84
2553,8,Laxmi1,2,5,110,111,447,534,363,450,84,87
2554,8,Laxmi1,2,6,111,119,552,692,465,605,87,140
2555,8,Laxmi1,2,7,119,32,252,378,112,238,140,126
2556,8,Laxmi1,2,8,32,119,1459,1606,1333,1480,126,147
2557,8,Laxmi1,2,9,119,104,381,518,234,371,147,137
2558,8,Laxmi1,2,10,104,97,562,705,425,568,137,143
2559,8,Laxmi1,2,11,97,116,183,297,40,154,143,114
2560,8,Laxmi1,2,12,116,32,310,419,196,305,114,109
2561,8,Laxmi1,2,13,32,119,946,1069,837,960,109,123
2562,8,Laxmi1,2,14,119,101,204,333,81,210,123,129
2563,8,Laxmi1,2,15,101,32,963,1132,834,1003,129,169
2564,8,Laxmi1,2,16,32,97,1602,1751,1433,1582,169,149
2565,8,Laxmi1,2,17,97,114,266,375,117,226,149,109
2566,8,Laxmi1,2,18,114,101,220,360,111,251,109,140
2567,8,Laxmi1,2,19,101,32,202,290,62,150,140,88
2568,8,Laxmi1,2,20,32,98,438,536,350,448,88,98
2569,8,Laxmi1,2,21,98,117,457,561,359,463,98,104
2570,8,Laxmi1,2,22,117,116,305,403,201,299,104,98
2571,8,Laxmi1,2,23,116,32,1060,1171,962,1073,98,111
2572,8,Laxmi1,2,24,32,107,1202,1318,1091,1207,111,116
2573,8,Laxmi1,2,25,107,110,269,351,153,235,116,82
2574,8,Laxmi1,2,26,110,111,396,508,314,426,82,112
2575,8,Laxmi1,2,27,111,119,402,550,290,438,112,148
2576,8,Laxmi1,2,28,119,32,305,432,157,284,148,127
2577,8,Laxmi1,2,29,32,110,796,887,669,760,127,91
2578,8,Laxmi1,2,30,110,111,344,439,253,348,91,95
2579,8,Laxmi1,2,31,111,116,386,477,291,382,95,91
2580,8,Laxmi1,2,32,116,32,336,453,245,362,91,117
2581,8,Laxmi1,2,33,32,119,854,988,737,871,117,134
2582,8,Laxmi1,2,34,119,104,247,358,113,224,134,111
2583,8,Laxmi1,2,35,104,97,352,525,241,414,111,173
2584,8,Laxmi1,2,36,97,116,214,316,41,143,173,102
2585,8,Laxmi1,2,37,116,32,274,384,172,282,102,110
2586,8,Laxmi1,2,38,32,119,165,303,55,193,110,138
2587,8,Laxmi1,2,39,119,101,233,371,95,233,138,138
2588,8,Laxmi1,2,40,101,32,176,278,38,140,138,102
2589,8,Laxmi1,2,41,32,109,823,922,721,820,102,99
2590,8,Laxmi1,2,42,109,97,228,376,129,277,99,148
2591,8,Laxmi1,2,43,97,121,400,514,252,366,148,114
2592,8,Laxmi1,2,44,121,32,394,529,280,415,114,135
2593,8,Laxmi1,2,45,32,98,578,686,443,551,135,108
2594,8,Laxmi1,2,46,98,101,259,369,151,261,108,110
2595,8,Laxmi1,3,0,13,121,1162,1251,1046,1135,116,89
2596,8,Laxmi1,3,1,121,111,436,513,347,424,89,77
2597,8,Laxmi1,3,2,111,117,232,311,155,234,77,79
2598,8,Laxmi1,3,3,117,32,262,379,183,300,79,117
2599,8,Laxmi1,3,4,32,99,402,498,285,381,117,96
2600,8,Laxmi1,3,5,99,97,256,394,160,298,96,138
2601,8,Laxmi1,3,6,97,110,269,402,131,264,138,133
2602,8,Laxmi1,3,7,110,116,360,468,227,335,133,108
2603,8,Laxmi1,3,8,116,32,866,1008,758,900,108,142
2604,8,Laxmi1,3,9,32,97,452,610,310,468,142,158
2605,8,Laxmi1,3,10,97,108,247,373,89,215,158,126
2606,8,Laxmi1,3,11,108,119,1057,1150,931,1024,126,93
2607,8,Laxmi1,3,12,119,97,244,389,151,296,93,145
2608,8,Laxmi1,3,13,97,121,351,458,206,313,145,107
2609,8,Laxmi1,3,14,121,115,213,355,106,248,107,142
2610,8,Laxmi1,3,15,115,32,423,586,281,444,142,163
2611,8,Laxmi1,3,16,32,104,880,939,717,776,163,59
2612,8,Laxmi1,3,17,104,97,540,700,481,641,59,160
2613,8,Laxmi1,3,18,97,118,561,661,401,501,160,100
2614,8,Laxmi1,3,19,118,101,300,439,200,339,100,139
2615,8,Laxmi1,3,20,101,32,158,283,19,144,139,125
2616,8,Laxmi1,3,21,32,97,221,354,96,229,125,133
2617,8,Laxmi1,3,22,97,32,177,308,44,175,133,131
2618,8,Laxmi1,3,23,32,103,296,386,165,255,131,90
2619,8,Laxmi1,3,24,103,111,491,591,401,501,90,100
2620,8,Laxmi1,3,25,111,111,137,241,37,141,100,104
2621,8,Laxmi1,3,26,111,100,220,371,116,267,104,151
2622,8,Laxmi1,3,27,100,32,189,311,38,160,151,122
2623,8,Laxmi1,3,28,32,100,1286,1372,1164,1250,122,86
2624,8,Laxmi1,3,29,100,97,224,387,138,301,86,163
2625,8,Laxmi1,3,30,97,121,321,419,158,256,163,98
2626,8,Laxmi1,3,31,121,32,285,386,187,288,98,101
2627,8,Laxmi1,3,32,32,98,577,666,476,565,101,89
2628,8,Laxmi1,3,33,98,117,577,680,488,591,89,103
2629,8,Laxmi1,3,34,117,116,264,356,161,253,103,92
2630,8,Laxmi1,3,35,116,32,662,786,570,694,92,124
2631,8,Laxmi1,3,36,32,121,683,742,559,618,124,59
2632,8,Laxmi1,3,37,121,111,526,630,467,571,59,104
2633,8,Laxmi1,3,38,111,117,246,331,142,227,104,85
2634,8,Laxmi1,3,39,117,32,1598,1709,1513,1624,85,111
2635,8,Laxmi1,3,40,32,99,189,268,78,157,111,79
2636,8,Laxmi1,3,41,99,97,604,769,525,690,79,165
2637,8,Laxmi1,3,42,97,110,317,431,152,266,165,114
2638,8,Laxmi1,3,43,110,32,231,331,117,217,114,100
2639,8,Laxmi1,3,44,32,97,1984,2182,1884,2082,100,198
2640,8,Laxmi1,3,45,97,108,282,406,84,208,198,124
2641,8,Laxmi1,3,46,108,119,454,610,330,486,124,156
2642,8,Laxmi1,3,47,119,97,431,600,275,444,156,169
2643,8,Laxmi1,3,48,97,121,305,414,136,245,169,109
2644,8,Laxmi1,3,49,121,115,281,440,172,331,109,159
2645,8,Laxmi1,3,50,115,32,884,994,725,835,159,110
2646,8,Laxmi1,3,51,32,102,549,654,439,544,110,105
2647,8,Laxmi1,3,52,102,97,274,432,169,327,105,158
2648,8,Laxmi1,3,53,97,99,245,353,87,195,158,108
2649,8,Laxmi1,3,54,99,101,232,384,124,276,108,152
2650,8,Laxmi1,3,55,101,32,186,317,34,165,152,131
2651,8,Laxmi1,3,56,32,97,204,380,73,249,131,176
2652,8,Laxmi1,3,57,97,32,208,303,32,127,176,95
2653,8,Laxmi1,3,58,32,98,444,543,349,448,95,99
2654,8,Laxmi1,3,59,98,97,233,395,134,296,99,162
2655,8,Laxmi1,3,60,97,100,251,359,89,197,162,108
2656,8,Laxmi1,3,61,100,32,649,797,541,689,108,148
2657,8,Laxmi1,3,62,32,100,645,768,497,620,148,123
2658,8,Laxmi1,3,63,100,97,263,415,140,292,123,152
2659,8,Laxmi1,3,64,97,121,288,409,136,257,152,121
2660,8,Laxmi1,3,65,121,32,320,441,199,320,121,121
2661,8,Laxmi1,3,66,32,119,1212,1385,1091,1264,121,173
2662,8,Laxmi1,3,67,119,105,385,509,212,336,173,124
2663,8,Laxmi1,3,68,105,116,360,462,236,338,124,102
2664,8,Laxmi1,3,69,116,104,247,364,145,262,102,117
2665,8,Laxmi1,3,70,104,32,387,502,270,385,117,115
2666,8,Laxmi1,3,71,32,97,1197,1369,1082,1254,115,172
2667,8,Laxmi1,3,72,97,32,204,289,32,117,172,85
2668,8,Laxmi1,3,73,32,103,280,377,195,292,85,97
2669,8,Laxmi1,3,74,103,111,488,562,391,465,97,74
2670,8,Laxmi1,3,75,111,111,140,234,66,160,74,94
2671,8,Laxmi1,3,76,111,100,316,483,222,389,94,167
2672,8,Laxmi1,3,77,100,32,223,328,56,161,167,105
2673,8,Laxmi1,3,78,32,97,707,862,602,757,105,155
2674,8,Laxmi1,3,79,97,116,272,364,117,209,155,92
2675,8,Laxmi1,3,80,116,116,162,269,70,177,92,107
2676,8,Laxmi1,3,81,116,105,441,561,334,454,107,120
2677,8,Laxmi1,3,82,105,116,351,448,231,328,120,97
2678,8,Laxmi1,3,83,116,117,318,423,221,326,97,105
2679,8,Laxmi1,3,84,117,100,430,522,325,417,105,92
2680,8,Laxmi1,3,85,100,101,238,407,146,315,92,169
2681,8,Laxmi1,4,0,13,116,750,846,650,746,100,96
2682,8,Laxmi1,4,1,116,104,219,324,123,228,96,105
2683,8,Laxmi1,4,2,104,101,206,331,101,226,105,125
2684,8,Laxmi1,4,3,101,32,165,295,40,170,125,130
2685,8,Laxmi1,4,4,32,98,331,430,201,300,130,99
2686,8,Laxmi1,4,5,98,101,374,494,275,395,99,120
2687,8,Laxmi1,4,6,101,115,341,517,221,397,120,176
2688,8,Laxmi1,4,7,115,116,195,310,19,134,176,115
2689,8,Laxmi1,4,8,116,32,317,427,202,312,115,110
2690,8,Laxmi1,4,9,32,112,1300,1393,1190,1283,110,93
2691,8,Laxmi1,4,10,112,114,569,696,476,603,93,127
2692,8,Laxmi1,4,11,114,101,214,361,87,234,127,147
2693,8,Laxmi1,4,12,101,112,517,615,370,468,147,98
2694,8,Laxmi1,4,13,112,97,261,434,163,336,98,173
2695,8,Laxmi1,4,14,97,114,280,382,107,209,173,102
2696,8,Laxmi1,4,15,114,97,191,367,89,265,102,176
2697,8,Laxmi1,4,16,97,116,196,292,20,116,176,96
2698,8,Laxmi1,4,17,116,105,483,593,387,497,96,110
2699,8,Laxmi1,4,18,105,111,209,312,99,202,110,103
2700,8,Laxmi1,4,19,111,110,249,356,146,253,103,107
2701,8,Laxmi1,4,20,110,32,234,328,127,221,107,94
2702,8,Laxmi1,4,21,32,102,1702,1843,1608,1749,94,141
2703,8,Laxmi1,4,22,102,111,251,354,110,213,141,103
2704,8,Laxmi1,4,23,111,114,229,349,126,246,103,120
2705,8,Laxmi1,4,24,114,32,202,322,82,202,120,120
2706,8,Laxmi1,4,25,32,116,352,444,232,324,120,92
2707,8,Laxmi1,4,26,116,111,500,597,408,505,92,97
2708,8,Laxmi1,4,27,111,109,242,366,145,269,97,124
2709,8,Laxmi1,4,28,109,111,514,612,390,488,124,98
2710,8,Laxmi1,4,29,111,114,437,507,339,409,98,70
2711,8,Laxmi1,4,30,114,114,1071,1167,1001,1097,70,96
2712,8,Laxmi1,4,31,114,111,2581,2681,2485,2585,96,100
2713,8,Laxmi1,4,32,111,119,521,661,421,561,100,140
2714,8,Laxmi1,4,33,119,32,207,323,67,183,140,116
2715,8,Laxmi1,4,34,32,105,707,809,591,693,116,102
2716,8,Laxmi1,4,35,105,115,306,438,204,336,102,132
2717,8,Laxmi1,4,36,115,32,166,265,34,133,132,99
2718,8,Laxmi1,4,37,32,100,329,468,230,369,99,139
2719,8,Laxmi1,4,38,100,111,184,285,45,146,139,101
2720,8,Laxmi1,4,39,111,105,174,266,73,165,101,92
2721,8,Laxmi1,4,40,105,110,1696,1834,1604,1742,92,138
2722,8,Laxmi1,4,41,110,103,464,576,326,438,138,112
2723,8,Laxmi1,4,42,103,32,330,446,218,334,112,116
2724,8,Laxmi1,4,43,32,121,827,935,711,819,116,108
2725,8,Laxmi1,4,44,121,111,529,641,421,533,108,112
2726,8,Laxmi1,4,45,111,117,283,369,171,257,112,86
2727,8,Laxmi1,4,46,117,114,306,446,220,360,86,140
2728,8,Laxmi1,4,47,114,32,184,298,44,158,140,114
2729,8,Laxmi1,4,48,32,98,385,508,271,394,114,123
2730,8,Laxmi1,4,49,98,101,294,408,171,285,123,114
2731,8,Laxmi1,4,50,101,115,292,446,178,332,114,154
2732,8,Laxmi1,4,51,115,116,186,279,32,125,154,93
2733,8,Laxmi1,4,52,116,32,248,360,155,267,93,112
2734,8,Laxmi1,4,53,32,116,299,368,187,256,112,69
2735,8,Laxmi1,4,54,116,111,595,735,526,666,69,140
2736,8,Laxmi1,4,55,111,100,476,570,336,430,140,94
2737,8,Laxmi1,4,56,100,97,203,375,109,281,94,172
2738,8,Laxmi1,4,57,97,121,331,431,159,259,172,100
2739,9,Anuradha,0,0,97,110,161,358,-61,136,222,197
2740,9,Anuradha,0,1,110,121,452,586,255,389,197,134
2741,9,Anuradha,0,2,121,32,2283,2463,2149,2329,134,180
2742,9,Anuradha,0,3,32,116,497,702,317,522,180,205
2743,9,Anuradha,0,4,116,114,119,297,-86,92,205,178
2744,9,Anuradha,0,5,114,97,618,793,440,615,178,175
2745,9,Anuradha,0,6,97,110,338,501,163,326,175,163
2746,9,Anuradha,0,7,110,115,300,476,137,313,163,176
2747,9,Anuradha,0,8,115,105,286,475,110,299,176,189
2748,9,Anuradha,0,9,105,116,569,754,380,565,189,185
2749,9,Anuradha,0,10,116,105,122,309,-63,124,185,187
2750,9,Anuradha,0,11,105,111,111,285,-76,98,187,174
2751,9,Anuradha,0,12,111,110,333,510,159,336,174,177
2752,9,Anuradha,0,13,110,32,489,670,312,493,177,181
2753,9,Anuradha,0,14,32,105,564,759,383,578,181,195
2754,9,Anuradha,0,15,105,115,336,515,141,320,195,179
2755,9,Anuradha,0,16,115,32,129,324,-50,145,179,195
2756,9,Anuradha,0,17,32,101,285,414,90,219,195,129
2757,9,Anuradha,0,18,101,97,277,428,148,299,129,151
2758,9,Anuradha,0,19,97,115,366,528,215,377,151,162
2759,9,Anuradha,0,20,115,105,239,415,77,253,162,176
2760,9,Anuradha,0,21,105,101,365,519,189,343,176,154
2761,9,Anuradha,0,22,101,114,452,606,298,452,154,154
2762,9,Anuradha,0,23,114,32,236,425,82,271,154,189
2763,9,Anuradha,0,24,32,105,829,1015,640,826,189,186
2764,9,Anuradha,0,25,105,102,218,358,32,172,186,140
2765,9,Anuradha,0,26,102,32,172,309,32,169,140,137
2766,9,Anuradha,0,27,32,121,869,1061,732,924,137,192
2767,9,Anuradha,0,28,121,111,172,361,-20,169,192,189
2768,9,Anuradha,0,29,111,117,306,503,117,314,189,197
2769,9,Anuradha,0,30,117,32,363,538,166,341,197,175
2770,9,Anuradha,0,31,32,98,808,969,633,794,175,161
2771,9,Anuradha,0,32,98,101,538,735,377,574,161,197
2772,9,Anuradha,0,33,101,108,244,419,47,222,197,175
2773,9,Anuradha,0,34,108,105,301,457,126,282,175,156
2774,9,Anuradha,0,35,105,101,323,470,167,314,156,147
2775,9,Anuradha,0,36,101,118,873,1063,726,916,147,190
2776,9,Anuradha,0,37,118,101,158,303,-32,113,190,145
2777,9,Anuradha,0,38,101,32,315,509,170,364,145,194
2778,9,Anuradha,0,39,32,105,561,784,367,590,194,223
2779,9,Anuradha,0,40,105,110,193,348,-30,125,223,155
2780,9,Anuradha,0,41,110,32,221,390,66,235,155,169
2781,9,Anuradha,0,42,32,121,498,681,329,512,169,183
2782,9,Anuradha,0,43,121,111,150,342,-33,159,183,192
2783,9,Anuradha,0,44,111,117,233,377,41,185,192,144
2784,9,Anuradha,0,45,117,114,794,922,650,778,144,128
2785,9,Anuradha,0,46,114,115,488,630,360,502,128,142
2786,9,Anuradha,0,47,115,101,302,470,160,328,142,168
2787,9,Anuradha,0,48,101,108,264,434,96,266,168,170
2788,9,Anuradha,0,49,108,102,900,1059,730,889,170,159
2789,9,Anuradha,0,50,102,32,408,592,249,433,159,184
2790,9,Anuradha,0,51,32,97,785,970,601,786,184,185
2791,9,Anuradha,0,52,97,110,243,468,58,283,185,225
2792,9,Anuradha,0,53,110,100,296,463,71,238,225,167
2793,9,Anuradha,0,54,100,32,225,398,58,231,167,173
2794,9,Anuradha,0,55,32,121,903,1055,730,882,173,152
2795,9,Anuradha,0,56,121,111,277,466,125,314,152,189
2796,9,Anuradha,0,57,111,117,281,436,92,247,189,155
2797,9,Anuradha,0,58,117,114,296,437,141,282,155,141
2798,9,Anuradha,0,59,114,32,183,350,42,209,141,167
2799,9,Anuradha,0,60,32,116,714,857,547,690,167,143
2800,9,Anuradha,0,61,116,97,111,253,-32,110,143,142
2801,9,Anuradha,0,62,97,108,507,674,365,532,142,167
2802,9,Anuradha,0,63,108,101,414,584,247,417,167,170
2803,9,Anuradha,0,64,101,110,312,495,142,325,170,183
2804,9,Anuradha,0,65,110,116,365,515,182,332,183,150
2805,9,Anuradha,1,0,13,105,1658,1865,1491,1698,167,207
2806,9,Anuradha,1,1,105,116,141,282,-66,75,207,141
2807,9,Anuradha,1,2,116,32,229,315,88,174,141,86
2808,9,Anuradha,1,3,32,100,1021,1229,935,1143,86,208
2809,9,Anuradha,1,4,100,111,193,399,-15,191,208,206
2810,9,Anuradha,1,5,111,101,487,594,281,388,206,107
2811,9,Anuradha,1,6,101,115,305,440,198,333,107,135
2812,9,Anuradha,1,7,115,32,223,397,88,262,135,174
2813,9,Anuradha,1,8,32,110,887,1044,713,870,174,157
2814,9,Anuradha,1,9,110,111,237,435,80,278,157,198
2815,9,Anuradha,1,10,111,116,503,633,305,435,198,130
2816,9,Anuradha,1,11,116,32,179,364,49,234,130,185
2817,9,Anuradha,1,12,32,109,746,904,561,719,185,158
2818,9,Anuradha,1,13,109,97,238,379,80,221,158,141
2819,9,Anuradha,1,14,97,116,444,582,303,441,141,138
2820,9,Anuradha,1,15,116,116,171,320,33,182,138,149
2821,9,Anuradha,1,16,116,101,320,538,171,389,149,218
2822,9,Anuradha,1,17,101,114,129,331,-89,113,218,202
2823,9,Anuradha,1,18,114,32,874,1074,672,872,202,200
2824,9,Anuradha,1,19,32,104,1442,1622,1242,1422,200,180
2825,9,Anuradha,1,20,104,111,1078,1277,898,1097,180,199
2826,9,Anuradha,1,21,111,119,244,408,45,209,199,164
2827,9,Anuradha,1,22,119,32,582,765,418,601,164,183
2828,9,Anuradha,1,23,32,115,700,884,517,701,183,184
2829,9,Anuradha,1,24,115,108,149,307,-35,123,184,158
2830,9,Anuradha,1,25,108,111,222,379,64,221,158,157
2831,9,Anuradha,1,26,111,119,421,576,264,419,157,155
2832,9,Anuradha,1,27,119,108,382,552,227,397,155,170
2833,9,Anuradha,1,28,108,121,490,651,320,481,170,161
2834,9,Anuradha,1,29,121,32,352,549,191,388,161,197
2835,9,Anuradha,1,30,32,121,1125,1281,928,1084,197,156
2836,9,Anuradha,1,31,121,111,305,491,149,335,156,186
2837,9,Anuradha,1,32,111,117,285,450,99,264,186,165
2838,9,Anuradha,1,33,117,32,357,525,192,360,165,168
2839,9,Anuradha,1,34,32,103,2240,2423,2072,2255,168,183
2840,9,Anuradha,1,35,103,111,150,365,-33,182,183,215
2841,9,Anuradha,1,36,111,32,329,533,114,318,215,204
2842,9,Anuradha,1,37,32,97,621,815,417,611,204,194
2843,9,Anuradha,1,38,97,115,178,365,-16,171,194,187
2844,9,Anuradha,1,39,115,32,170,353,-17,166,187,183
2845,9,Anuradha,1,40,32,108,412,582,229,399,183,170
2846,9,Anuradha,1,41,108,111,203,359,33,189,170,156
2847,9,Anuradha,1,42,111,110,382,543,226,387,156,161
2848,9,Anuradha,1,43,110,103,310,462,149,301,161,152
2849,9,Anuradha,1,44,103,32,618,798,466,646,152,180
2850,9,Anuradha,1,45,32,97,687,978,507,798,180,291
2851,9,Anuradha,1,46,97,115,223,388,-68,97,291,165
2852,9,Anuradha,1,47,115,32,394,577,229,412,165,183
2853,9,Anuradha,1,48,32,121,1594,1758,1411,1575,183,164
2854,9,Anuradha,1,49,121,111,134,333,-30,169,164,199
2855,9,Anuradha,1,50,111,117,255,433,56,234,199,178
2856,9,Anuradha,1,51,117,32,306,508,128,330,178,202
2857,9,Anuradha,1,52,32,100,799,1014,597,812,202,215
2858,9,Anuradha,1,53,100,111,427,612,212,397,215,185
2859,9,Anuradha,1,54,111,32,287,485,102,300,185,198
2860,9,Anuradha,1,55,32,110,251,429,53,231,198,178
2861,9,Anuradha,1,56,110,111,348,516,170,338,178,168
2862,9,Anuradha,1,57,111,116,472,628,304,460,168,156
2863,9,Anuradha,1,58,116,32,201,409,45,253,156,208
2864,9,Anuradha,1,59,32,115,844,1007,636,799,208,163
2865,9,Anuradha,1,60,115,116,724,927,561,764,163,203
2866,9,Anuradha,1,61,116,111,389,581,186,378,203,192
2867,9,Anuradha,1,62,111,112,380,565,188,373,192,185
2868,9,Anuradha,2,0,13,119,802,987,627,812,175,185
2869,9,Anuradha,2,1,119,101,118,303,-67,118,185,185
2870,9,Anuradha,2,2,101,32,221,406,36,221,185,185
2871,9,Anuradha,2,3,32,107,989,1163,804,978,185,174
2872,9,Anuradha,2,4,107,110,240,392,66,218,174,152
2873,9,Anuradha,2,5,110,111,265,431,113,279,152,166
2874,9,Anuradha,2,6,111,119,440,610,274,444,166,170
2875,9,Anuradha,2,7,119,32,351,526,181,356,170,175
2876,9,Anuradha,2,8,32,119,711,881,536,706,175,170
2877,9,Anuradha,2,9,119,104,594,769,424,599,170,175
2878,9,Anuradha,2,10,104,97,220,379,45,204,175,159
2879,9,Anuradha,2,11,97,116,225,413,66,254,159,188
2880,9,Anuradha,2,12,116,32,255,430,67,242,188,175
2881,9,Anuradha,2,13,32,119,690,892,515,717,175,202
2882,9,Anuradha,2,14,119,101,118,303,-84,101,202,185
2883,9,Anuradha,2,15,101,32,205,396,20,211,185,191
2884,9,Anuradha,2,16,32,97,815,1041,624,850,191,226
2885,9,Anuradha,2,17,97,114,207,384,-19,158,226,177
2886,9,Anuradha,2,18,114,101,223,375,46,198,177,152
2887,9,Anuradha,2,19,101,32,253,395,101,243,152,142
2888,9,Anuradha,2,20,32,98,867,1041,725,899,142,174
2889,9,Anuradha,2,21,98,117,246,440,72,266,174,194
2890,9,Anuradha,2,22,117,116,290,505,96,311,194,215
2891,9,Anuradha,2,23,116,32,296,504,81,289,215,208
2892,9,Anuradha,2,24,32,107,864,1070,656,862,208,206
2893,9,Anuradha,2,25,107,110,184,357,-22,151,206,173
2894,9,Anuradha,2,26,110,111,443,618,270,445,173,175
2895,9,Anuradha,2,27,111,119,1348,1525,1173,1350,175,177
2896,9,Anuradha,2,28,119,32,778,974,601,797,177,196
2897,9,Anuradha,2,29,32,110,627,796,431,600,196,169
2898,9,Anuradha,2,30,110,111,1633,1849,1464,1680,169,216
2899,9,Anuradha,2,31,111,116,750,938,534,722,216,188
2900,9,Anuradha,2,32,116,32,351,553,163,365,188,202
2901,9,Anuradha,2,33,32,119,1857,2055,1655,1853,202,198
2902,9,Anuradha,2,34,119,104,240,410,42,212,198,170
2903,9,Anuradha,2,35,104,97,465,655,295,485,170,190
2904,9,Anuradha,2,36,97,116,221,397,31,207,190,176
2905,9,Anuradha,2,37,116,32,250,443,74,267,176,193
2906,9,Anuradha,2,38,32,119,683,901,490,708,193,218
2907,9,Anuradha,2,39,119,101,127,310,-91,92,218,183
2908,9,Anuradha,2,40,101,32,158,345,-25,162,183,187
2909,9,Anuradha,2,41,32,109,227,422,40,235,187,195
2910,9,Anuradha,2,42,109,97,230,418,35,223,195,188
2911,9,Anuradha,2,43,97,121,236,430,48,242,188,194
2912,9,Anuradha,2,44,121,32,173,361,-21,167,194,188
2913,9,Anuradha,2,45,32,98,669,867,481,679,188,198
2914,9,Anuradha,2,46,98,101,135,302,-63,104,198,167
2915,9,Anuradha,3,0,13,121,1517,1712,1303,1498,214,195
2916,9,Anuradha,3,1,121,111,139,346,-56,151,195,207
2917,9,Anuradha,3,2,111,117,244,439,37,232,207,195
2918,9,Anuradha,3,3,117,32,174,336,-21,141,195,162
2919,9,Anuradha,3,4,32,99,391,548,229,386,162,157
2920,9,Anuradha,3,5,99,97,190,320,33,163,157,130
2921,9,Anuradha,3,6,97,110,1104,1310,974,1180,130,206
2922,9,Anuradha,3,7,110,116,1070,1238,864,1032,206,168
2923,9,Anuradha,3,8,116,32,279,475,111,307,168,196
2924,9,Anuradha,3,9,32,97,654,861,458,665,196,207
2925,9,Anuradha,3,10,97,108,160,356,-47,149,207,196
2926,9,Anuradha,3,11,108,119,326,448,130,252,196,122
2927,9,Anuradha,3,12,119,97,203,400,81,278,122,197
2928,9,Anuradha,3,13,97,121,922,1135,725,938,197,213
2929,9,Anuradha,3,14,121,115,197,341,-16,128,213,144
2930,9,Anuradha,3,15,115,32,564,761,420,617,144,197
2931,9,Anuradha,3,16,32,104,609,783,412,586,197,174
2932,9,Anuradha,3,17,104,97,120,308,-54,134,174,188
2933,9,Anuradha,3,18,97,118,204,401,16,213,188,197
2934,9,Anuradha,3,19,118,101,300,468,103,271,197,168
2935,9,Anuradha,3,20,101,32,186,375,18,207,168,189
2936,9,Anuradha,3,21,32,97,366,559,177,370,189,193
2937,9,Anuradha,3,22,97,32,175,364,-18,171,193,189
2938,9,Anuradha,3,23,32,103,535,708,346,519,189,173
2939,9,Anuradha,3,24,103,111,306,432,133,259,173,126
2940,9,Anuradha,3,25,111,111,170,343,44,217,126,173
2941,9,Anuradha,3,26,111,100,1227,1418,1054,1245,173,191
2942,9,Anuradha,3,27,100,32,251,432,60,241,191,181
2943,9,Anuradha,3,28,32,100,844,1005,663,824,181,161
2944,9,Anuradha,3,29,100,97,145,302,-16,141,161,157
2945,9,Anuradha,3,30,97,121,249,416,92,259,157,167
2946,9,Anuradha,3,31,121,32,367,543,200,376,167,176
2947,9,Anuradha,3,32,32,98,955,1148,779,972,176,193
2948,9,Anuradha,3,33,98,117,289,464,96,271,193,175
2949,9,Anuradha,3,34,117,116,323,499,148,324,175,176
2950,9,Anuradha,3,35,116,32,217,434,41,258,176,217
2951,9,Anuradha,3,36,32,121,1392,1598,1175,1381,217,206
2952,9,Anuradha,3,37,121,111,152,353,-54,147,206,201
2953,9,Anuradha,3,38,111,117,218,379,17,178,201,161
2954,9,Anuradha,3,39,117,32,214,386,53,225,161,172
2955,9,Anuradha,3,40,32,99,772,929,600,757,172,157
2956,9,Anuradha,3,41,99,97,424,587,267,430,157,163
2957,9,Anuradha,3,42,97,110,183,337,20,174,163,154
2958,9,Anuradha,3,43,110,32,173,362,19,208,154,189
2959,9,Anuradha,3,44,32,97,664,864,475,675,189,200
2960,9,Anuradha,3,45,97,108,150,324,-50,124,200,174
2961,9,Anuradha,3,46,108,119,371,490,197,316,174,119
2962,9,Anuradha,3,47,119,97,217,378,98,259,119,161
2963,9,Anuradha,3,48,97,121,417,590,256,429,161,173
2964,9,Anuradha,3,49,121,115,256,444,83,271,173,188
2965,9,Anuradha,3,50,115,32,259,452,71,264,188,193
2966,9,Anuradha,3,51,32,102,1124,1298,931,1105,193,174
2967,9,Anuradha,3,52,102,97,154,307,-20,133,174,153
2968,9,Anuradha,3,53,97,99,171,331,18,178,153,160
2969,9,Anuradha,3,54,99,101,289,446,129,286,160,157
2970,9,Anuradha,3,55,101,32,232,411,75,254,157,179
2971,9,Anuradha,3,56,32,97,682,904,503,725,179,222
2972,9,Anuradha,3,57,97,32,164,370,-58,148,222,206
2973,9,Anuradha,3,58,32,98,473,628,267,422,206,155
2974,9,Anuradha,3,59,98,97,120,279,-35,124,155,159
2975,9,Anuradha,3,60,97,100,229,362,70,203,159,133
2976,9,Anuradha,3,61,100,32,179,365,46,232,133,186
2977,9,Anuradha,3,62,32,100,1058,1192,872,1006,186,134
2978,9,Anuradha,3,63,100,97,179,413,45,279,134,234
2979,9,Anuradha,3,64,97,121,295,456,61,222,234,161
2980,9,Anuradha,3,65,121,32,232,403,71,242,161,171
2981,9,Anuradha,3,66,32,119,935,1146,764,975,171,211
2982,9,Anuradha,3,67,119,105,140,309,-71,98,211,169
2983,9,Anuradha,3,68,105,116,475,665,306,496,169,190
2984,9,Anuradha,3,69,116,104,158,336,-32,146,190,178
2985,9,Anuradha,3,70,104,32,220,394,42,216,178,174
2986,9,Anuradha,3,71,32,97,493,701,319,527,174,208
2987,9,Anuradha,3,72,97,32,175,373,-33,165,208,198
2988,9,Anuradha,3,73,32,103,909,1083,711,885,198,174
2989,9,Anuradha,3,74,103,111,296,406,122,232,174,110
2990,9,Anuradha,3,75,111,111,153,313,43,203,110,160
2991,9,Anuradha,3,76,111,100,246,422,86,262,160,176
2992,9,Anuradha,3,77,100,32,157,342,-19,166,176,185
2993,9,Anuradha,3,78,32,97,374,542,189,357,185,168
2994,9,Anuradha,3,79,97,116,439,553,271,385,168,114
2995,9,Anuradha,3,80,116,116,161,282,47,168,114,121
2996,9,Anuradha,3,81,116,105,523,670,402,549,121,147
2997,9,Anuradha,3,82,105,116,522,676,375,529,147,154
2998,9,Anuradha,3,83,116,117,282,459,128,305,154,177
2999,9,Anuradha,3,84,117,100,805,1008,628,831,177,203
3000,9,Anuradha,3,85,100,101,337,502,134,299,203,165
3001,9,Anuradha,4,0,13,116,1670,1830,1495,1655,175,160
3002,9,Anuradha,4,1,116,104,199,370,39,210,160,171
3003,9,Anuradha,4,2,104,101,257,412,86,241,171,155
3004,9,Anuradha,4,3,101,32,136,326,-19,171,155,190
3005,9,Anuradha,4,4,32,98,651,812,461,622,190,161
3006,9,Anuradha,4,5,98,101,365,507,204,346,161,142
3007,9,Anuradha,4,6,101,115,332,505,190,363,142,173
3008,9,Anuradha,4,7,115,116,307,446,134,273,173,139
3009,9,Anuradha,4,8,116,32,535,725,396,586,139,190
3010,9,Anuradha,4,9,32,112,730,917,540,727,190,187
3011,9,Anuradha,4,10,112,114,375,581,188,394,187,206
3012,9,Anuradha,4,11,114,101,158,293,-48,87,206,135
3013,9,Anuradha,4,12,101,112,235,409,100,274,135,174
3014,9,Anuradha,4,13,112,97,280,448,106,274,174,168
3015,9,Anuradha,4,14,97,114,489,632,321,464,168,143
3016,9,Anuradha,4,15,114,97,812,974,669,831,143,162
3017,9,Anuradha,4,16,97,116,658,877,496,715,162,219
3018,9,Anuradha,4,17,116,105,146,330,-73,111,219,184
3019,9,Anuradha,4,18,105,111,103,313,-81,129,184,210
3020,9,Anuradha,4,19,111,110,1088,1238,878,1028,210,150
3021,9,Anuradha,4,20,110,32,169,361,19,211,150,192
3022,9,Anuradha,4,21,32,102,626,812,434,620,192,186
3023,9,Anuradha,4,22,102,111,219,400,33,214,186,181
3024,9,Anuradha,4,23,111,114,221,405,40,224,181,184
3025,9,Anuradha,4,24,114,32,154,341,-30,157,184,187
3026,9,Anuradha,4,25,32,116,634,847,447,660,187,213
3027,9,Anuradha,4,26,116,111,258,417,45,204,213,159
3028,9,Anuradha,4,27,111,109,879,1059,720,900,159,180
3029,9,Anuradha,4,28,109,111,245,414,65,234,180,169
3030,9,Anuradha,4,29,111,114,468,593,299,424,169,125
3031,9,Anuradha,4,30,114,114,165,284,40,159,125,119
3032,9,Anuradha,4,31,114,111,260,435,141,316,119,175
3033,9,Anuradha,4,32,111,119,319,433,144,258,175,114
3034,9,Anuradha,4,33,119,32,178,366,64,252,114,188
3035,9,Anuradha,4,34,32,105,789,970,601,782,188,181
3036,9,Anuradha,4,35,105,115,431,605,250,424,181,174
3037,9,Anuradha,4,36,115,32,153,334,-21,160,174,181
3038,9,Anuradha,4,37,32,100,664,857,483,676,181,193
3039,9,Anuradha,4,38,100,111,160,355,-33,162,193,195
3040,9,Anuradha,4,39,111,105,173,346,-22,151,195,173
3041,9,Anuradha,4,40,105,110,262,437,89,264,173,175
3042,9,Anuradha,4,41,110,103,461,607,286,432,175,146
3043,9,Anuradha,4,42,103,32,289,457,143,311,146,168
3044,9,Anuradha,4,43,32,121,1313,1492,1145,1324,168,179
3045,9,Anuradha,4,44,121,111,130,352,-49,173,179,222
3046,9,Anuradha,4,45,111,117,196,355,-26,133,222,159
3047,9,Anuradha,4,46,117,114,634,791,475,632,159,157
3048,9,Anuradha,4,47,114,32,189,372,32,215,157,183
3049,9,Anuradha,4,48,32,98,811,1010,628,827,183,199
3050,9,Anuradha,4,49,98,101,495,609,296,410,199,114
3051,9,Anuradha,4,50,101,115,146,305,32,191,114,159
3052,9,Anuradha,4,51,115,116,308,432,149,273,159,124
3053,9,Anuradha,4,52,116,32,182,340,58,216,124,158
3054,9,Anuradha,4,53,32,116,554,741,396,583,158,187
3055,9,Anuradha,4,54,116,111,221,411,34,224,187,190
3056,9,Anuradha,4,55,111,100,683,852,493,662,190,169
3057,9,Anuradha,4,56,100,97,514,745,345,576,169,231
3058,9,Anuradha,4,57,97,121,290,417,59,186,231,127
3059,10,Namita,0,0,97,110,339,508,166,335,173,169
3060,10,Namita,0,1,110,121,523,676,354,507,169,153
3061,10,Namita,0,2,121,32,1018,1144,865,991,153,126
3062,10,Namita,0,3,32,116,657,811,531,685,126,154
3063,10,Namita,0,4,116,114,291,480,137,326,154,189
3064,10,Namita,0,5,114,97,1012,1224,823,1035,189,212
3065,10,Namita,0,6,97,110,245,399,33,187,212,154
3066,10,Namita,0,7,110,115,1014,1159,860,1005,154,145
3067,10,Namita,0,8,115,105,389,519,244,374,145,130
3068,10,Namita,0,9,105,116,409,554,279,424,130,145
3069,10,Namita,0,10,116,105,177,323,32,178,145,146
3070,10,Namita,0,11,105,111,239,405,93,259,146,166
3071,10,Namita,0,12,111,110,1151,1294,985,1128,166,143
3072,10,Namita,0,13,110,32,390,490,247,347,143,100
3073,10,Namita,0,14,32,105,1051,1173,951,1073,100,122
3074,10,Namita,0,15,105,115,336,493,214,371,122,157
3075,10,Namita,0,16,115,32,236,380,79,223,157,144
3076,10,Namita,0,17,32,101,233,348,89,204,144,115
3077,10,Namita,0,18,101,97,348,506,233,391,115,158
3078,10,Namita,0,19,97,115,252,366,94,208,158,114
3079,10,Namita,0,20,115,105,727,859,613,745,114,132
3080,10,Namita,0,21,105,101,415,549,283,417,132,134
3081,10,Namita,0,22,101,114,152,344,18,210,134,192
3082,10,Namita,0,23,114,32,1257,1420,1065,1228,192,163
3083,10,Namita,0,24,32,105,637,764,474,601,163,127
3084,10,Namita,0,25,105,102,642,817,515,690,127,175
3085,10,Namita,0,26,102,32,234,401,59,226,175,167
3086,10,Namita,0,27,32,121,733,876,566,709,167,143
3087,10,Namita,0,28,121,111,486,646,343,503,143,160
3088,10,Namita,0,29,111,117,305,454,145,294,160,149
3089,10,Namita,0,30,117,32,271,420,122,271,149,149
3090,10,Namita,0,31,32,98,1190,1334,1041,1185,149,144
3091,10,Namita,0,32,98,101,553,697,409,553,144,144
3092,10,Namita,0,33,101,108,272,412,128,268,144,140
3093,10,Namita,0,34,108,101,511,682,371,542,140,171
3094,10,Namita,0,35,101,118,384,511,213,340,171,127
3095,10,Namita,0,36,118,105,462,599,335,472,127,137
3096,10,Namita,0,37,105,101,280,457,143,320,137,177
3097,10,Namita,0,38,101,8,2379,2506,2202,2329,177,127
3098,10,Namita,0,39,8,8,318,499,191,372,127,181
3099,10,Namita,0,40,8,8,919,1114,738,933,181,195
3100,10,Namita,0,41,8,8,479,632,284,437,195,153
3101,10,Namita,0,42,8,105,1231,1365,1078,1212,153,134
3102,10,Namita,0,43,105,101,504,657,370,523,134,153
3103,10,Namita,0,44,101,118,234,387,81,234,153,153
3104,10,Namita,0,45,118,101,243,419,90,266,153,176
3105,10,Namita,0,46,101,32,745,919,569,743,176,174
3106,10,Namita,0,47,32,105,1044,1169,870,995,174,125
3107,10,Namita,0,48,105,110,294,397,169,272,125,103
3108,10,Namita,0,49,110,32,239,409,136,306,103,170
3109,10,Namita,0,50,32,121,525,635,355,465,170,110
3110,10,Namita,0,51,121,111,437,567,327,457,110,130
3111,10,Namita,0,52,111,117,284,387,154,257,130,103
3112,10,Namita,0,53,117,114,402,509,299,406,103,107
3113,10,Namita,0,54,114,115,518,668,411,561,107,150
3114,10,Namita,0,55,115,101,203,308,53,158,150,105
3115,10,Namita,0,56,101,108,610,759,505,654,105,149
3116,10,Namita,0,57,108,102,289,465,140,316,149,176
3117,10,Namita,0,58,102,32,295,422,119,246,176,127
3118,10,Namita,0,59,32,97,969,1115,842,988,127,146
3119,10,Namita,0,60,97,110,265,415,119,269,146,150
3120,10,Namita,0,61,110,100,265,442,115,292,150,177
3121,10,Namita,0,62,100,32,303,468,126,291,177,165
3122,10,Namita,0,63,32,121,1186,1323,1021,1158,165,137
3123,10,Namita,0,64,121,111,295,432,158,295,137,137
3124,10,Namita,0,65,111,117,247,371,110,234,137,124
3125,10,Namita,0,66,117,114,388,563,264,439,124,175
3126,10,Namita,0,67,114,32,292,424,117,249,175,132
3127,10,Namita,0,68,32,116,168,292,36,160,132,124
3128,10,Namita,0,69,116,97,489,638,365,514,124,149
3129,10,Namita,0,70,97,108,435,596,286,447,149,161
3130,10,Namita,0,71,108,101,318,507,157,346,161,189
3131,10,Namita,0,72,101,110,510,653,321,464,189,143
3132,10,Namita,0,73,110,116,346,489,203,346,143,143
3133,10,Namita,1,0,13,105,1925,2080,1819,1974,106,155
3134,10,Namita,1,1,105,116,350,481,195,326,155,131
3135,10,Namita,1,2,116,32,219,353,88,222,131,134
3136,10,Namita,1,3,32,100,289,460,155,326,134,171
3137,10,Namita,1,4,100,111,692,823,521,652,171,131
3138,10,Namita,1,5,111,101,329,471,198,340,131,142
3139,10,Namita,1,6,101,115,340,449,198,307,142,109
3140,10,Namita,1,7,115,32,293,443,184,334,109,150
3141,10,Namita,1,8,32,110,322,455,172,305,150,133
3142,10,Namita,1,9,110,111,429,561,296,428,133,132
3143,10,Namita,1,10,111,116,310,473,178,341,132,163
3144,10,Namita,1,11,116,32,673,806,510,643,163,133
3145,10,Namita,1,12,32,109,589,723,456,590,133,134
3146,10,Namita,1,13,109,97,284,442,150,308,134,158
3147,10,Namita,1,14,97,116,392,513,234,355,158,121
3148,10,Namita,1,15,116,116,185,272,64,151,121,87
3149,10,Namita,1,16,116,101,386,528,299,441,87,142
3150,10,Namita,1,17,101,114,175,335,33,193,142,160
3151,10,Namita,1,18,114,32,272,437,112,277,160,165
3152,10,Namita,1,19,32,104,1260,1402,1095,1237,165,142
3153,10,Namita,1,20,104,111,430,580,288,438,142,150
3154,10,Namita,1,21,111,119,748,885,598,735,150,137
3155,10,Namita,1,22,119,32,249,380,112,243,137,131
3156,10,Namita,1,23,32,115,188,353,57,222,131,165
3157,10,Namita,1,24,115,108,1669,1824,1504,1659,165,155
3158,10,Namita,1,25,108,111,1247,1384,1092,1229,155,137
3159,10,Namita,1,26,111,119,1175,1336,1038,1199,137,161
3160,10,Namita,1,27,119,108,385,542,224,381,161,157
3161,10,Namita,1,28,108,121,442,589,285,432,157,147
3162,10,Namita,1,29,121,32,291,423,144,276,147,132
3163,10,Namita,1,30,32,121,1278,1463,1146,1331,132,185
3164,10,Namita,1,31,121,111,242,389,57,204,185,147
3165,10,Namita,1,32,111,117,258,407,111,260,147,149
3166,10,Namita,1,33,117,32,206,339,57,190,149,133
3167,10,Namita,1,34,32,103,2137,2281,2004,2148,133,144
3168,10,Namita,1,35,103,111,163,309,19,165,144,146
3169,10,Namita,1,36,111,97,450,654,304,508,146,204
3170,10,Namita,1,37,97,115,184,317,-20,113,204,133
3171,10,Namita,1,38,115,32,288,406,155,273,133,118
3172,10,Namita,1,39,32,108,403,556,285,438,118,153
3173,10,Namita,1,40,108,111,254,384,101,231,153,130
3174,10,Namita,1,41,111,97,266,453,136,323,130,187
3175,10,Namita,1,42,97,8,1251,1392,1064,1205,187,141
3176,10,Namita,1,43,8,110,466,540,325,399,141,74
3177,10,Namita,1,44,110,8,3112,3306,3038,3232,74,194
3178,10,Namita,1,45,8,8,288,468,94,274,194,180
3179,10,Namita,1,46,8,8,238,420,58,240,180,182
3180,10,Namita,1,47,8,8,288,486,106,304,182,198
3181,10,Namita,1,48,8,8,464,658,266,460,198,194
3182,10,Namita,1,49,8,8,421,581,227,387,194,160
3183,10,Namita,1,50,8,32,378,531,218,371,160,153
3184,10,Namita,1,51,32,97,699,882,546,729,153,183
3185,10,Namita,1,52,97,115,470,576,287,393,183,106
3186,10,Namita,1,53,115,32,366,491,260,385,106,125
3187,10,Namita,1,54,32,108,467,595,342,470,125,128
3188,10,Namita,1,55,108,111,194,330,66,202,128,136
3189,10,Namita,1,56,111,110,676,825,540,689,136,149
3190,10,Namita,1,57,110,103,2512,2665,2363,2516,149,153
3191,10,Namita,1,58,103,32,402,576,249,423,153,174
3192,10,Namita,1,59,32,97,722,918,548,744,174,196
3193,10,Namita,1,60,97,115,1139,1258,943,1062,196,119
3194,10,Namita,1,61,115,32,390,514,271,395,119,124
3195,10,Namita,1,62,32,121,903,1116,779,992,124,213
3196,10,Namita,1,63,121,111,164,350,-49,137,213,186
3197,10,Namita,1,64,111,117,867,1032,681,846,186,165
3198,10,Namita,1,65,117,32,301,449,136,284,165,148
3199,10,Namita,1,66,32,100,1470,1648,1322,1500,148,178
3200,10,Namita,1,67,100,111,230,387,52,209,178,157
3201,10,Namita,1,68,111,32,295,438,138,281,157,143
3202,10,Namita,1,69,32,110,283,422,140,279,143,139
3203,10,Namita,1,70,110,111,340,507,201,368,139,167
3204,10,Namita,1,71,111,116,219,378,52,211,167,159
3205,10,Namita,1,72,116,32,215,362,56,203,159,147
3206,10,Namita,1,73,32,115,312,535,165,388,147,223
3207,10,Namita,1,74,115,116,303,447,80,224,223,144
3208,10,Namita,1,75,116,111,520,654,376,510,144,134
3209,10,Namita,1,76,111,112,204,345,70,211,134,141
3210,10,Namita,2,0,13,119,1089,1262,987,1160,102,173
3211,10,Namita,2,1,119,101,302,437,129,264,173,135
3212,10,Namita,2,2,101,32,336,486,201,351,135,150
3213,10,Namita,2,3,32,107,1188,1309,1038,1159,150,121
3214,10,Namita,2,4,107,110,298,427,177,306,121,129
3215,10,Namita,2,5,110,111,435,559,306,430,129,124
3216,10,Namita,2,6,111,119,656,822,532,698,124,166
3217,10,Namita,2,7,119,32,252,402,86,236,166,150
3218,10,Namita,2,8,32,119,1804,1972,1654,1822,150,168
3219,10,Namita,2,9,119,104,336,474,168,306,168,138
3220,10,Namita,2,10,104,97,414,625,276,487,138,211
3221,10,Namita,2,11,97,116,266,425,55,214,211,159
3222,10,Namita,2,12,116,32,914,1050,755,891,159,136
3223,10,Namita,2,13,32,119,1091,1245,955,1109,136,154
3224,10,Namita,2,14,119,101,236,355,82,201,154,119
3225,10,Namita,2,15,101,32,274,421,155,302,119,147
3226,10,Namita,2,16,32,97,190,352,43,205,147,162
3227,10,Namita,2,17,97,114,195,336,33,174,162,141
3228,10,Namita,2,18,114,101,313,451,172,310,141,138
3229,10,Namita,2,19,101,32,228,379,90,241,138,151
3230,10,Namita,2,20,32,98,1190,1374,1039,1223,151,184
3231,10,Namita,2,21,98,117,400,546,216,362,184,146
3232,10,Namita,2,22,117,116,296,476,150,330,146,180
3233,10,Namita,2,23,116,32,375,522,195,342,180,147
3234,10,Namita,2,24,32,107,658,785,511,638,147,127
3235,10,Namita,2,25,107,110,661,768,534,641,127,107
3236,10,Namita,2,26,110,111,410,556,303,449,107,146
3237,10,Namita,2,27,111,119,678,852,532,706,146,174
3238,10,Namita,2,28,119,32,1352,1514,1178,1340,174,162
3239,10,Namita,2,29,32,110,654,774,492,612,162,120
3240,10,Namita,2,30,110,111,384,535,264,415,120,151
3241,10,Namita,2,31,111,116,330,456,179,305,151,126
3242,10,Namita,2,32,116,32,239,432,113,306,126,193
3243,10,Namita,2,33,32,97,407,591,214,398,193,184
3244,10,Namita,2,34,97,104,716,867,532,683,184,151
3245,10,Namita,2,35,104,8,2093,2228,1942,2077,151,135
3246,10,Namita,2,36,8,8,177,332,42,197,135,155
3247,10,Namita,2,37,8,119,1099,1281,944,1126,155,182
3248,10,Namita,2,38,119,104,508,668,326,486,182,160
3249,10,Namita,2,39,104,97,361,557,201,397,160,196
3250,10,Namita,2,40,97,116,162,360,-34,164,196,198
3251,10,Namita,2,41,116,32,828,976,630,778,198,148
3252,10,Namita,2,42,32,119,1975,2157,1827,2009,148,182
3253,10,Namita,2,43,119,101,240,395,58,213,182,155
3254,10,Namita,2,44,101,32,425,557,270,402,155,132
3255,10,Namita,2,45,32,109,287,413,155,281,132,126
3256,10,Namita,2,46,109,97,303,512,177,386,126,209
3257,10,Namita,2,47,97,121,191,367,-18,158,209,176
3258,10,Namita,2,48,121,32,1094,1280,918,1104,176,186
3259,10,Namita,2,49,32,98,772,935,586,749,186,163
3260,10,Namita,2,50,98,101,303,497,140,334,163,194
3261,10,Namita,3,0,13,121,3584,3716,3464,3596,120,132
3262,10,Namita,3,1,121,111,162,344,30,212,132,182
3263,10,Namita,3,2,111,117,307,439,125,257,182,132
3264,10,Namita,3,3,117,32,309,453,177,321,132,144
3265,10,Namita,3,4,32,99,1154,1322,1010,1178,144,168
3266,10,Namita,3,5,99,97,424,593,256,425,168,169
3267,10,Namita,3,6,97,110,202,356,33,187,169,154
3268,10,Namita,3,7,110,116,353,490,199,336,154,137
3269,10,Namita,3,8,116,32,183,318,46,181,137,135
3270,10,Namita,3,9,32,97,301,457,166,322,135,156
3271,10,Namita,3,10,97,108,348,493,192,337,156,145
3272,10,Namita,3,11,108,119,508,648,363,503,145,140
3273,10,Namita,3,12,119,97,264,450,124,310,140,186
3274,10,Namita,3,13,97,121,736,877,550,691,186,141
3275,10,Namita,3,14,121,115,533,694,392,553,141,161
3276,10,Namita,3,15,115,32,1283,1420,1122,1259,161,137
3277,10,Namita,3,16,32,104,572,722,435,585,137,150
3278,10,Namita,3,17,104,97,343,511,193,361,150,168
3279,10,Namita,3,18,97,118,272,401,104,233,168,129
3280,10,Namita,3,19,118,101,286,436,157,307,129,150
3281,10,Namita,3,20,101,97,440,595,290,445,150,155
3282,10,Namita,3,21,97,8,2379,2488,2224,2333,155,109
3283,10,Namita,3,22,8,109,383,474,274,365,109,91
3284,10,Namita,3,23,109,8,872,1016,781,925,91,144
3285,10,Namita,3,24,8,32,381,553,237,409,144,172
3286,10,Namita,3,25,32,97,351,517,179,345,172,166
3287,10,Namita,3,26,97,32,308,483,142,317,166,175
3288,10,Namita,3,27,32,103,966,1149,791,974,175,183
3289,10,Namita,3,28,103,111,325,468,142,285,183,143
3290,10,Namita,3,29,111,111,191,339,48,196,143,148
3291,10,Namita,3,30,111,100,924,1090,776,942,148,166
3292,10,Namita,3,31,100,32,346,509,180,343,166,163
3293,10,Namita,3,32,32,100,1377,1522,1214,1359,163,145
3294,10,Namita,3,33,100,97,233,423,88,278,145,190
3295,10,Namita,3,34,97,121,344,483,154,293,190,139
3296,10,Namita,3,35,121,32,284,475,145,336,139,191
3297,10,Namita,3,36,32,98,1510,1755,1319,1564,191,245
3298,10,Namita,3,37,98,117,933,1089,688,844,245,156
3299,10,Namita,3,38,117,116,407,601,251,445,156,194
3300,10,Namita,3,39,116,32,335,518,141,324,194,183
3301,10,Namita,3,40,32,121,1543,1683,1360,1500,183,140
3302,10,Namita,3,41,121,111,159,331,19,191,140,172
3303,10,Namita,3,42,111,117,301,443,129,271,172,142
3304,10,Namita,3,43,117,32,246,424,104,282,142,178
3305,10,Namita,3,44,32,99,846,1059,668,881,178,213
3306,10,Namita,3,45,99,97,472,682,259,469,213,210
3307,10,Namita,3,46,97,110,176,381,-34,171,210,205
3308,10,Namita,3,47,110,32,380,534,175,329,205,154
3309,10,Namita,3,48,32,97,1269,1460,1115,1306,154,191
3310,10,Namita,3,49,97,108,475,630,284,439,191,155
3311,10,Namita,3,50,108,119,275,422,120,267,155,147
3312,10,Namita,3,51,119,97,352,554,205,407,147,202
3313,10,Namita,3,52,97,121,755,890,553,688,202,135
3314,10,Namita,3,53,121,115,607,793,472,658,135,186
3315,10,Namita,3,54,115,32,326,470,140,284,186,144
3316,10,Namita,3,55,32,102,825,961,681,817,144,136
3317,10,Namita,3,56,102,97,502,669,366,533,136,167
3318,10,Namita,3,57,97,99,219,395,52,228,167,176
3319,10,Namita,3,58,99,101,322,485,146,309,176,163
3320,10,Namita,3,59,101,32,260,422,97,259,163,162
3321,10,Namita,3,60,32,97,255,416,93,254,162,161
3322,10,Namita,3,61,97,32,531,713,370,552,161,182
3323,10,Namita,3,62,32,98,356,539,174,357,182,183
3324,10,Namita,3,63,98,97,951,1137,768,954,183,186
3325,10,Namita,3,64,97,100,297,461,111,275,186,164
3326,10,Namita,3,65,100,32,643,816,479,652,164,173
3327,10,Namita,3,66,32,100,1212,1369,1039,1196,173,157
3328,10,Namita,3,67,100,97,232,431,75,274,157,199
3329,10,Namita,3,68,97,121,639,786,440,587,199,147
3330,10,Namita,3,69,121,32,375,538,228,391,147,163
3331,10,Namita,3,70,32,119,663,854,500,691,163,191
3332,10,Namita,3,71,119,105,491,624,300,433,191,133
3333,10,Namita,3,72,105,116,485,630,352,497,133,145
3334,10,Namita,3,73,116,104,191,364,46,219,145,173
3335,10,Namita,3,74,104,32,1321,1508,1148,1335,173,187
3336,10,Namita,3,75,32,97,1041,1227,854,1040,187,186
3337,10,Namita,3,76,97,32,265,425,79,239,186,160
3338,10,Namita,3,77,32,103,1646,1808,1486,1648,160,162
3339,10,Namita,3,78,103,111,414,537,252,375,162,123
3340,10,Namita,3,79,111,111,165,297,42,174,123,132
3341,10,Namita,3,80,111,115,965,1113,833,981,132,148
3342,10,Namita,3,81,115,8,856,999,708,851,148,143
3343,10,Namita,3,82,8,100,315,481,172,338,143,166
3344,10,Namita,3,83,100,32,259,409,93,243,166,150
3345,10,Namita,3,84,32,97,215,395,65,245,150,180
3346,10,Namita,3,85,97,116,430,575,250,395,180,145
3347,10,Namita,3,86,116,116,1130,1263,985,1118,145,133
3348,10,Namita,3,87,116,105,426,547,293,414,133,121
3349,10,Namita,3,88,105,117,248,370,127,249,121,122
3350,10,Namita,3,89,117,116,601,735,479,613,122,134
3351,10,Namita,3,90,116,8,2678,2877,2544,2743,134,199
3352,10,Namita,3,91,8,8,336,495,137,296,199,159
3353,10,Namita,3,92,8,116,841,1003,682,844,159,162
3354,10,Namita,3,93,116,117,201,400,39,238,162,199
3355,10,Namita,3,94,117,100,638,812,439,613,199,174
3356,10,Namita,3,95,100,101,259,488,85,314,174,229
3357,10,Namita,4,0,13,116,1395,1536,1265,1406,130,141
3358,10,Namita,4,1,116,104,635,785,494,644,141,150
3359,10,Namita,4,2,104,101,413,574,263,424,150,161
3360,10,Namita,4,3,101,32,243,424,82,263,161,181
3361,10,Namita,4,4,32,98,371,507,190,326,181,136
3362,10,Namita,4,5,98,101,277,431,141,295,136,154
3363,10,Namita,4,6,101,100,485,592,331,438,154,107
3364,10,Namita,4,7,100,8,793,915,686,808,107,122
3365,10,Namita,4,8,8,115,310,511,188,389,122,201
3366,10,Namita,4,9,115,116,184,315,-17,114,201,131
3367,10,Namita,4,10,116,32,446,604,315,473,131,158
3368,10,Namita,4,11,32,112,1274,1428,1116,1270,158,154
3369,10,Namita,4,12,112,114,595,735,441,581,154,140
3370,10,Namita,4,13,114,101,327,501,187,361,140,174
3371,10,Namita,4,14,101,112,520,694,346,520,174,174
3372,10,Namita,4,15,112,97,265,475,91,301,174,210
3373,10,Namita,4,16,97,114,354,505,144,295,210,151
3374,10,Namita,4,17,114,97,1474,1656,1323,1505,151,182
3375,10,Namita,4,18,97,116,773,978,591,796,182,205
3376,10,Namita,4,19,116,105,277,441,72,236,205,164
3377,10,Namita,4,20,105,111,259,407,95,243,164,148
3378,10,Namita,4,21,111,110,321,466,173,318,148,145
3379,10,Namita,4,22,110,32,421,597,276,452,145,176
3380,10,Namita,4,23,32,102,737,913,561,737,176,176
3381,10,Namita,4,24,102,111,417,583,241,407,176,166
3382,10,Namita,4,25,111,114,314,495,148,329,166,181
3383,10,Namita,4,26,114,32,279,434,98,253,181,155
3384,10,Namita,4,27,32,116,575,719,420,564,155,144
3385,10,Namita,4,28,116,111,261,418,117,274,144,157
3386,10,Namita,4,29,111,109,661,773,504,616,157,112
3387,10,Namita,4,30,109,111,855,1006,743,894,112,151
3388,10,Namita,4,31,111,114,412,549,261,398,151,137
3389,10,Namita,4,32,114,114,185,358,48,221,137,173
3390,10,Namita,4,33,114,111,726,875,553,702,173,149
3391,10,Namita,4,34,111,119,564,764,415,615,149,200
3392,10,Namita,4,35,119,32,1209,1417,1009,1217,200,208
3393,10,Namita,4,36,32,105,410,587,202,379,208,177
3394,10,Namita,4,37,105,115,497,662,320,485,177,165
3395,10,Namita,4,38,115,32,285,455,120,290,165,170
3396,10,Namita,4,39,32,100,1306,1474,1136,1304,170,168
3397,10,Namita,4,40,100,112,345,476,177,308,168,131
3398,10,Namita,4,41,112,8,704,853,573,722,131,149
3399,10,Namita,4,42,8,111,409,554,260,405,149,145
3400,10,Namita,4,43,111,105,627,754,482,609,145,127
3401,10,Namita,4,44,105,110,294,410,167,283,127,116
3402,10,Namita,4,45,110,103,525,686,409,570,116,161
3403,10,Namita,4,46,103,32,2474,2647,2313,2486,161,173
3404,10,Namita,4,47,32,121,778,964,605,791,173,186
3405,10,Namita,4,48,121,111,232,407,46,221,186,175
3406,10,Namita,4,49,111,117,261,470,86,295,175,209
3407,10,Namita,4,50,117,114,1518,1675,1309,1466,209,157
3408,10,Namita,4,51,114,32,393,592,236,435,157,199
3409,10,Namita,4,52,32,98,867,1012,668,813,199,145
3410,10,Namita,4,53,98,101,328,485,183,340,145,157
3411,10,Namita,4,54,101,115,322,548,165,391,157,226
3412,10,Namita,4,55,115,116,418,539,192,313,226,121
3413,10,Namita,4,56,116,32,1272,1404,1151,1283,121,132
3414,10,Namita,4,57,32,116,638,798,506,666,132,160
3415,10,Namita,4,58,116,111,231,393,71,233,160,162
3416,10,Namita,4,59,111,100,440,572,278,410,162,132
3417,10,Namita,4,60,100,97,274,452,142,320,132,178
3418,10,Namita,4,61,97,121,665,761,487,583,178,96
